CPRO;PROVINCIA;CMUN;NOMBRE;POB20;HOMBRES;MUJERES
02;Albacete;001;Abengibre;761;365;396
02;Albacete;002;Alatoz;506;283;223
02;Albacete;003;Albacete;174336;85214;89122
02;Albacete;004;Albatana;679;351;328
02;Albacete;005;Alborea;664;346;318
02;Albacete;006;Alcadozo;647;350;297
02;Albacete;007;Alcalá del Júcar;1194;640;554
02;Albacete;008;Alcaraz;1324;687;637
02;Albacete;009;Almansa;24511;12208;12303
02;Albacete;010;Alpera;2261;1170;1091
02;Albacete;011;Ayna;591;311;280
02;Albacete;012;Balazote;2327;1187;1140
02;Albacete;014;Ballestero, El;396;203;193
02;Albacete;013;Balsa de Ves;131;77;54
02;Albacete;015;Barrax;1799;923;876
02;Albacete;016;Bienservida;579;313;266
02;Albacete;017;Bogarra;807;426;381
02;Albacete;018;Bonete;1029;530;499
02;Albacete;019;Bonillo, El;2723;1386;1337
02;Albacete;020;Carcelén;495;265;230
02;Albacete;021;Casas de Juan Núñez;1326;713;613
02;Albacete;022;Casas de Lázaro;348;196;152
02;Albacete;023;Casas de Ves;563;293;270
02;Albacete;024;Casas-Ibáñez;4544;2281;2263
02;Albacete;025;Caudete;10005;5098;4907
02;Albacete;026;Cenizate;1194;601;593
02;Albacete;029;Chinchilla de Monte-Aragón;4205;2199;2006
02;Albacete;027;Corral-Rubio;311;167;144
02;Albacete;028;Cotillas;118;62;56
02;Albacete;030;Elche de la Sierra;3520;1747;1773
02;Albacete;031;Férez;629;316;313
02;Albacete;032;Fuensanta;291;170;121
02;Albacete;033;Fuente-Álamo;2474;1290;1184
02;Albacete;034;Fuentealbilla;1831;941;890
02;Albacete;035;Gineta, La;2548;1322;1226
02;Albacete;036;Golosalvo;98;52;46
02;Albacete;037;Hellín;30200;15119;15081
02;Albacete;038;Herrera, La;322;164;158
02;Albacete;039;Higueruela;1135;589;546
02;Albacete;040;Hoya-Gonzalo;630;339;291
02;Albacete;041;Jorquera;342;186;156
02;Albacete;042;Letur;892;434;458
02;Albacete;043;Lezuza;1332;692;640
02;Albacete;044;Liétor;1150;591;559
02;Albacete;045;Madrigueras;4634;2367;2267
02;Albacete;046;Mahora;1362;702;660
02;Albacete;047;Masegoso;104;57;47
02;Albacete;048;Minaya;1475;756;719
02;Albacete;049;Molinicos;813;421;392
02;Albacete;050;Montalvos;88;47;41
02;Albacete;051;Montealegre del Castillo;2041;1045;996
02;Albacete;052;Motilleja;578;313;265
02;Albacete;053;Munera;3429;1768;1661
02;Albacete;054;Navas de Jorquera;521;274;247
02;Albacete;055;Nerpio;1178;654;524
02;Albacete;056;Ontur;1976;1001;975
02;Albacete;057;Ossa de Montiel;2262;1134;1128
02;Albacete;058;Paterna del Madera;329;178;151
02;Albacete;060;Peñas de San Pedro;1394;815;579
02;Albacete;059;Peñascosa;333;186;147
02;Albacete;061;Pétrola;681;352;329
02;Albacete;062;Povedilla;405;225;180
02;Albacete;901;Pozo Cañada;2791;1413;1378
02;Albacete;063;Pozohondo;1593;830;763
02;Albacete;064;Pozo-Lorente;408;208;200
02;Albacete;065;Pozuelo;469;251;218
02;Albacete;066;Recueja, La;231;126;105
02;Albacete;067;Riópar;1341;687;654
02;Albacete;068;Robledo;376;206;170
02;Albacete;069;Roda, La;15527;7853;7674
02;Albacete;070;Salobre;470;251;219
02;Albacete;071;San Pedro;1171;598;573
02;Albacete;072;Socovos;1778;919;859
02;Albacete;073;Tarazona de la Mancha;6187;3165;3022
02;Albacete;074;Tobarra;7709;3958;3751
02;Albacete;075;Valdeganga;1990;1023;967
02;Albacete;076;Vianos;329;170;159
02;Albacete;077;Villa de Ves;61;35;26
02;Albacete;078;Villalgordo del Júcar;1102;583;519
02;Albacete;079;Villamalea;4070;2078;1992
02;Albacete;080;Villapalacios;583;307;276
02;Albacete;081;Villarrobledo;25116;12434;12682
02;Albacete;082;Villatoya;109;64;45
02;Albacete;083;Villavaliente;220;134;86
02;Albacete;084;Villaverde de Guadalimar;325;171;154
02;Albacete;085;Viveros;329;171;158
02;Albacete;086;Yeste;2614;1354;1260
03;Alicante/Alacant;002;Agost;4794;2398;2396
03;Alicante/Alacant;003;Agres;564;309;255
03;Alicante/Alacant;004;Aigües;986;506;480
03;Alicante/Alacant;005;Albatera;12474;6356;6118
03;Alicante/Alacant;006;Alcalalí;1302;653;649
03;Alicante/Alacant;007;Alcocer de Planes;226;113;113
03;Alicante/Alacant;008;Alcoleja;177;98;79
03;Alicante/Alacant;009;Alcoy/Alcoi;59354;29107;30247
03;Alicante/Alacant;010;Alfafara;406;198;208
03;Alicante/Alacant;011;Alfàs del Pi, l';20042;9945;10097
03;Alicante/Alacant;012;Algorfa;3125;1595;1530
03;Alicante/Alacant;013;Algueña;1326;668;658
03;Alicante/Alacant;014;Alicante/Alacant;337482;163385;174097
03;Alicante/Alacant;015;Almoradí;21208;10694;10514
03;Alicante/Alacant;016;Almudaina;109;53;56
03;Alicante/Alacant;017;Alqueria d'Asnar, l';493;241;252
03;Alicante/Alacant;018;Altea;22558;11045;11513
03;Alicante/Alacant;019;Aspe;20804;10471;10333
03;Alicante/Alacant;001;Atzúbia, l';611;314;297
03;Alicante/Alacant;020;Balones;128;71;57
03;Alicante/Alacant;021;Banyeres de Mariola;7090;3548;3542
03;Alicante/Alacant;022;Benasau;156;75;81
03;Alicante/Alacant;023;Beneixama;1690;845;845
03;Alicante/Alacant;024;Benejúzar;5435;2711;2724
03;Alicante/Alacant;025;Benferri;1965;1016;949
03;Alicante/Alacant;026;Beniarbeig;2159;1096;1063
03;Alicante/Alacant;027;Beniardá;200;97;103
03;Alicante/Alacant;028;Beniarrés;1099;563;536
03;Alicante/Alacant;030;Benidoleig;1078;536;542
03;Alicante/Alacant;031;Benidorm;70450;35214;35236
03;Alicante/Alacant;032;Benifallim;104;57;47
03;Alicante/Alacant;033;Benifato;136;71;65
03;Alicante/Alacant;029;Benigembla;443;227;216
03;Alicante/Alacant;034;Benijófar;3293;1604;1689
03;Alicante/Alacant;035;Benilloba;726;384;342
03;Alicante/Alacant;036;Benillup;100;52;48
03;Alicante/Alacant;037;Benimantell;497;253;244
03;Alicante/Alacant;038;Benimarfull;396;201;195
03;Alicante/Alacant;039;Benimassot;103;55;48
03;Alicante/Alacant;040;Benimeli;429;197;232
03;Alicante/Alacant;041;Benissa;11288;5546;5742
03;Alicante/Alacant;042;Benitachell/Poble Nou de Benitatxell, el;4452;2200;2252
03;Alicante/Alacant;043;Biar;3655;1795;1860
03;Alicante/Alacant;044;Bigastro;6909;3481;3428
03;Alicante/Alacant;045;Bolulla;417;218;199
03;Alicante/Alacant;046;Busot;3075;1563;1512
03;Alicante/Alacant;049;Callosa de Segura;19127;9756;9371
03;Alicante/Alacant;048;Callosa d'en Sarrià;7522;3871;3651
03;Alicante/Alacant;047;Calp;23326;11775;11551
03;Alicante/Alacant;050;Campello, el;28930;14076;14854
03;Alicante/Alacant;051;Campo de Mirra/Camp de Mirra, el;417;212;205
03;Alicante/Alacant;052;Cañada;1208;596;612
03;Alicante/Alacant;053;Castalla;10461;5331;5130
03;Alicante/Alacant;054;Castell de Castells;437;231;206
03;Alicante/Alacant;075;Castell de Guadalest, el;224;111;113
03;Alicante/Alacant;055;Catral;8898;4468;4430
03;Alicante/Alacant;056;Cocentaina;11520;5852;5668
03;Alicante/Alacant;057;Confrides;261;149;112
03;Alicante/Alacant;058;Cox;7386;3757;3629
03;Alicante/Alacant;059;Crevillent;29536;14967;14569
03;Alicante/Alacant;061;Daya Nueva;1733;844;889
03;Alicante/Alacant;062;Daya Vieja;731;371;360
03;Alicante/Alacant;063;Dénia;42827;20723;22104
03;Alicante/Alacant;064;Dolores;7531;3756;3775
03;Alicante/Alacant;065;Elche/Elx;234765;116386;118379
03;Alicante/Alacant;066;Elda;52813;25738;27075
03;Alicante/Alacant;067;Facheca;107;56;51
03;Alicante/Alacant;068;Famorca;45;24;21
03;Alicante/Alacant;069;Finestrat;7103;3645;3458
03;Alicante/Alacant;077;Fondó de les Neus, el/Hondón de las Nieves;2606;1333;1273
03;Alicante/Alacant;070;Formentera del Segura;4268;2168;2100
03;Alicante/Alacant;072;Gaianes;479;236;243
03;Alicante/Alacant;071;Gata de Gorgos;6243;3181;3062
03;Alicante/Alacant;073;Gorga;241;130;111
03;Alicante/Alacant;074;Granja de Rocamora;2591;1356;1235
03;Alicante/Alacant;076;Guardamar del Segura;15849;7735;8114
03;Alicante/Alacant;078;Hondón de los Frailes;1242;633;609
03;Alicante/Alacant;079;Ibi;23564;11776;11788
03;Alicante/Alacant;080;Jacarilla;1998;1024;974
03;Alicante/Alacant;082;Jávea/Xàbia;28016;13928;14088
03;Alicante/Alacant;083;Jijona/Xixona;6879;3355;3524
03;Alicante/Alacant;085;Llíber;830;414;416
03;Alicante/Alacant;084;Lorcha/Orxa, l';582;289;293
03;Alicante/Alacant;086;Millena;240;127;113
03;Alicante/Alacant;088;Monforte del Cid;8346;4375;3971
03;Alicante/Alacant;089;Monóvar/Monòver;12212;6097;6115
03;Alicante/Alacant;903;Montesinos, Los;5061;2579;2482
03;Alicante/Alacant;091;Murla;507;234;273
03;Alicante/Alacant;092;Muro de Alcoy;9315;4636;4679
03;Alicante/Alacant;090;Mutxamel;25645;12822;12823
03;Alicante/Alacant;093;Novelda;25741;12806;12935
03;Alicante/Alacant;094;Nucia, la;18163;9236;8927
03;Alicante/Alacant;095;Ondara;7076;3569;3507
03;Alicante/Alacant;096;Onil;7600;3791;3809
03;Alicante/Alacant;097;Orba;2232;1106;1126
03;Alicante/Alacant;099;Orihuela;78505;38965;39540
03;Alicante/Alacant;098;Orxeta;784;400;384
03;Alicante/Alacant;100;Parcent;967;473;494
03;Alicante/Alacant;101;Pedreguer;7881;3927;3954
03;Alicante/Alacant;102;Pego;10133;5041;5092
03;Alicante/Alacant;103;Penàguila;269;142;127
03;Alicante/Alacant;104;Petrer;34241;17004;17237
03;Alicante/Alacant;902;Pilar de la Horadada;22347;11467;10880
03;Alicante/Alacant;105;Pinós, el/Pinoso;8025;4055;3970
03;Alicante/Alacant;106;Planes;682;367;315
03;Alicante/Alacant;901;Poblets, els;2714;1298;1416
03;Alicante/Alacant;107;Polop;5064;2599;2465
03;Alicante/Alacant;060;Quatretondeta;118;64;54
03;Alicante/Alacant;109;Rafal;4553;2259;2294
03;Alicante/Alacant;110;Ràfol d'Almúnia, el;648;329;319
03;Alicante/Alacant;111;Redován;7926;4116;3810
03;Alicante/Alacant;112;Relleu;1148;598;550
03;Alicante/Alacant;113;Rojales;16671;8517;8154
03;Alicante/Alacant;114;Romana, la;2492;1291;1201
03;Alicante/Alacant;115;Sagra;426;207;219
03;Alicante/Alacant;116;Salinas;1620;834;786
03;Alicante/Alacant;118;San Fulgencio;8071;4090;3981
03;Alicante/Alacant;904;San Isidro;2103;1094;1009
03;Alicante/Alacant;120;San Miguel de Salinas;6313;3178;3135
03;Alicante/Alacant;122;San Vicente del Raspeig/Sant Vicent del Raspeig;58978;29149;29829
03;Alicante/Alacant;117;Sanet y Negrals;690;354;336
03;Alicante/Alacant;119;Sant Joan d'Alacant;24367;11742;12625
03;Alicante/Alacant;121;Santa Pola;33303;16742;16561
03;Alicante/Alacant;123;Sax;9859;4978;4881
03;Alicante/Alacant;124;Sella;577;299;278
03;Alicante/Alacant;125;Senija;583;308;275
03;Alicante/Alacant;127;Tàrbena;623;321;302
03;Alicante/Alacant;128;Teulada;11278;5656;5622
03;Alicante/Alacant;129;Tibi;1662;884;778
03;Alicante/Alacant;130;Tollos;35;22;13
03;Alicante/Alacant;131;Tormos;318;154;164
03;Alicante/Alacant;132;Torremanzanas/Torre de les Maçanes, la;636;335;301
03;Alicante/Alacant;133;Torrevieja;84667;41717;42950
03;Alicante/Alacant;134;Vall d'Alcalà, la;160;89;71
03;Alicante/Alacant;136;Vall de Gallinera;527;280;247
03;Alicante/Alacant;137;Vall de Laguar, la;827;413;414
03;Alicante/Alacant;135;Vall d'Ebo, la;218;113;105
03;Alicante/Alacant;138;Verger, el;4709;2353;2356
03;Alicante/Alacant;139;Villajoyosa/Vila Joiosa, la;35199;17546;17653
03;Alicante/Alacant;140;Villena;34155;17193;16962
03;Alicante/Alacant;081;Xaló;2868;1437;1431
04;Almería;001;Abla;1248;632;616
04;Almería;002;Abrucena;1183;630;553
04;Almería;003;Adra;25412;13025;12387
04;Almería;004;Albanchez;687;344;343
04;Almería;005;Alboloduy;609;296;313
04;Almería;006;Albox;12083;6188;5895
04;Almería;007;Alcolea;844;435;409
04;Almería;008;Alcóntar;514;284;230
04;Almería;009;Alcudia de Monteagud;138;71;67
04;Almería;010;Alhabia;677;356;321
04;Almería;011;Alhama de Almería;3691;1858;1833
04;Almería;012;Alicún;201;102;99
04;Almería;013;Almería;201322;98531;102791
04;Almería;014;Almócita;176;94;82
04;Almería;015;Alsodux;125;76;49
04;Almería;016;Antas;3315;1724;1591
04;Almería;017;Arboleas;4624;2309;2315
04;Almería;018;Armuña de Almanzora;300;145;155
04;Almería;019;Bacares;250;135;115
04;Almería;904;Balanegra;3105;1658;1447
04;Almería;020;Bayárcal;312;173;139
04;Almería;021;Bayarque;216;104;112
04;Almería;022;Bédar;984;505;479
04;Almería;023;Beires;120;57;63
04;Almería;024;Benahadux;4481;2218;2263
04;Almería;026;Benitagla;58;32;26
04;Almería;027;Benizalón;262;141;121
04;Almería;028;Bentarique;240;135;105
04;Almería;029;Berja;12563;6397;6166
04;Almería;030;Canjáyar;1189;626;563
04;Almería;031;Cantoria;3365;1712;1653
04;Almería;032;Carboneras;8105;4166;3939
04;Almería;033;Castro de Filabres;120;63;57
04;Almería;036;Chercos;298;152;146
04;Almería;037;Chirivel;1489;760;729
04;Almería;034;Cóbdar;178;98;80
04;Almería;035;Cuevas del Almanzora;14455;7522;6933
04;Almería;038;Dalías;4066;2014;2052
04;Almería;902;Ejido, El;83758;43396;40362
04;Almería;041;Enix;514;286;228
04;Almería;043;Felix;636;365;271
04;Almería;044;Fines;2104;1100;1004
04;Almería;045;Fiñana;1984;998;986
04;Almería;046;Fondón;994;509;485
04;Almería;047;Gádor;3034;1581;1453
04;Almería;048;Gallardos, Los;2902;1469;1433
04;Almería;049;Garrucha;9520;4967;4553
04;Almería;050;Gérgal;1080;568;512
04;Almería;051;Huécija;486;238;248
04;Almería;052;Huércal de Almería;17917;9094;8823
04;Almería;053;Huércal-Overa;19432;9655;9777
04;Almería;054;Íllar;405;217;188
04;Almería;055;Instinción;448;234;214
04;Almería;056;Laroya;198;114;84
04;Almería;057;Láujar de Andarax;1527;761;766
04;Almería;058;Líjar;394;212;182
04;Almería;059;Lubrín;1449;720;729
04;Almería;060;Lucainena de las Torres;564;293;271
04;Almería;061;Lúcar;760;374;386
04;Almería;062;Macael;5480;2807;2673
04;Almería;063;María;1230;635;595
04;Almería;064;Mojácar;6778;3312;3466
04;Almería;903;Mojonera, La;9191;5191;4000
04;Almería;065;Nacimiento;496;265;231
04;Almería;066;Níjar;31666;17779;13887
04;Almería;067;Ohanes;558;283;275
04;Almería;068;Olula de Castro;191;106;85
04;Almería;069;Olula del Río;6256;3214;3042
04;Almería;070;Oria;2239;1169;1070
04;Almería;071;Padules;414;219;195
04;Almería;072;Partaloa;1035;523;512
04;Almería;073;Paterna del Río;365;210;155
04;Almería;074;Pechina;4103;2085;2018
04;Almería;075;Pulpí;10358;5363;4995
04;Almería;076;Purchena;1664;868;796
04;Almería;077;Rágol;303;155;148
04;Almería;078;Rioja;1453;739;714
04;Almería;079;Roquetas de Mar;98433;50782;47651
04;Almería;080;Santa Cruz de Marchena;199;99;100
04;Almería;081;Santa Fe de Mondújar;461;236;225
04;Almería;082;Senés;289;159;130
04;Almería;083;Serón;2033;1040;993
04;Almería;084;Sierro;379;208;171
04;Almería;085;Somontín;443;224;219
04;Almería;086;Sorbas;2436;1274;1162
04;Almería;087;Suflí;196;105;91
04;Almería;088;Tabernas;3717;1900;1817
04;Almería;089;Taberno;974;478;496
04;Almería;090;Tahal;336;172;164
04;Almería;091;Terque;365;192;173
04;Almería;092;Tíjola;3548;1776;1772
04;Almería;901;Tres Villas, Las;565;303;262
04;Almería;093;Turre;3781;1967;1814
04;Almería;094;Turrillas;248;141;107
04;Almería;095;Uleila del Campo;822;413;409
04;Almería;096;Urrácal;350;182;168
04;Almería;097;Velefique;230;127;103
04;Almería;098;Vélez-Blanco;1874;965;909
04;Almería;099;Vélez-Rubio;6546;3206;3340
04;Almería;100;Vera;16996;8655;8341
04;Almería;101;Viator;5978;3058;2920
04;Almería;102;Vícar;26899;14569;12330
04;Almería;103;Zurgena;2956;1485;1471
01;Araba/Álava;051;Agurain/Salvatierra;5038;2537;2501
01;Araba/Álava;001;Alegría-Dulantzi;2935;1531;1404
01;Araba/Álava;002;Amurrio;10264;5044;5220
01;Araba/Álava;049;Añana;149;89;60
01;Araba/Álava;003;Aramaio;1442;748;694
01;Araba/Álava;006;Armiñón;223;115;108
01;Araba/Álava;037;Arraia-Maeztu;733;414;319
01;Araba/Álava;008;Arratzua-Ubarrundia;984;539;445
01;Araba/Álava;004;Artziniega;1800;892;908
01;Araba/Álava;009;Asparrena;1623;833;790
01;Araba/Álava;010;Ayala/Aiara;2968;1500;1468
01;Araba/Álava;011;Baños de Ebro/Mañueta;294;166;128
01;Araba/Álava;013;Barrundia;881;483;398
01;Araba/Álava;014;Berantevilla;463;240;223
01;Araba/Álava;016;Bernedo;507;305;202
01;Araba/Álava;017;Campezo/Kanpezu;1034;547;487
01;Araba/Álava;021;Elburgo/Burgelu;608;317;291
01;Araba/Álava;022;Elciego;1001;500;501
01;Araba/Álava;023;Elvillar/Bilar;330;162;168
01;Araba/Álava;047;Erriberabeitia;1383;748;635
01;Araba/Álava;046;Erriberagoitia/Ribera Alta;782;455;327
01;Araba/Álava;056;Harana/Valle de Arana;218;121;97
01;Araba/Álava;901;Iruña Oka/Iruña de Oca;3488;1821;1667
01;Araba/Álava;027;Iruraiz-Gauna;532;290;242
01;Araba/Álava;019;Kripan;178;92;86
01;Araba/Álava;020;Kuartango;385;224;161
01;Araba/Álava;028;Labastida/Bastida;1517;779;738
01;Araba/Álava;030;Lagrán;162;90;72
01;Araba/Álava;031;Laguardia;1454;750;704
01;Araba/Álava;032;Lanciego/Lantziego;709;383;326
01;Araba/Álava;902;Lantarón;877;488;389
01;Araba/Álava;033;Lapuebla de Labarca;865;441;424
01;Araba/Álava;036;Laudio/Llodio;18118;8868;9250
01;Araba/Álava;058;Legutio;1921;1010;911
01;Araba/Álava;034;Leza;211;106;105
01;Araba/Álava;039;Moreda de Álava/Moreda Araba;211;105;106
01;Araba/Álava;041;Navaridas;194;114;80
01;Araba/Álava;042;Okondo;1203;629;574
01;Araba/Álava;043;Oyón-Oion;3410;1729;1681
01;Araba/Álava;044;Peñacerrada-Urizaharra;262;156;106
01;Araba/Álava;052;Samaniego;315;148;167
01;Araba/Álava;053;San Millán/Donemiliaga;706;386;320
01;Araba/Álava;054;Urkabustaiz;1386;723;663
01;Araba/Álava;055;Valdegovía/Gaubea;986;538;448
01;Araba/Álava;057;Villabuena de Álava/Eskuernaga;274;141;133
01;Araba/Álava;059;Vitoria-Gasteiz;253996;123627;130369
01;Araba/Álava;060;Yécora/Iekora;270;139;131
01;Araba/Álava;061;Zalduondo;185;105;80
01;Araba/Álava;062;Zambrana;416;220;196
01;Araba/Álava;018;Zigoitia;1749;948;801
01;Araba/Álava;063;Zuia;2300;1188;1112
33;Asturias;001;Allande;1615;799;816
33;Asturias;002;Aller;10413;5141;5272
33;Asturias;003;Amieva;628;362;266
33;Asturias;004;Avilés;77791;36800;40991
33;Asturias;005;Belmonte de Miranda;1437;775;662
33;Asturias;006;Bimenes;1679;803;876
33;Asturias;007;Boal;1482;748;734
33;Asturias;008;Cabrales;1941;980;961
33;Asturias;009;Cabranes;1057;531;526
33;Asturias;010;Candamo;1969;961;1008
33;Asturias;012;Cangas de Onís;6209;3002;3207
33;Asturias;011;Cangas del Narcea;12124;5951;6173
33;Asturias;013;Caravia;469;245;224
33;Asturias;014;Carreño;10301;4953;5348
33;Asturias;015;Caso;1457;838;619
33;Asturias;016;Castrillón;22273;10774;11499
33;Asturias;017;Castropol;3342;1632;1710
33;Asturias;018;Coaña;3296;1612;1684
33;Asturias;019;Colunga;3205;1592;1613
33;Asturias;020;Corvera de Asturias;15525;7599;7926
33;Asturias;021;Cudillero;4922;2431;2491
33;Asturias;022;Degaña;881;456;425
33;Asturias;023;Franco, El;3760;1849;1911
33;Asturias;024;Gijón;271717;127961;143756
33;Asturias;025;Gozón;10282;5025;5257
33;Asturias;026;Grado;9703;4713;4990
33;Asturias;027;Grandas de Salime;815;419;396
33;Asturias;028;Ibias;1207;695;512
33;Asturias;029;Illano;333;168;165
33;Asturias;030;Illas;1023;514;509
33;Asturias;031;Langreo;39183;18687;20496
33;Asturias;032;Laviana;12882;6175;6707
33;Asturias;033;Lena;10701;5153;5548
33;Asturias;035;Llanera;13695;6797;6898
33;Asturias;036;Llanes;13473;6551;6922
33;Asturias;037;Mieres;37537;17827;19710
33;Asturias;038;Morcín;2555;1274;1281
33;Asturias;039;Muros de Nalón;1887;905;982
33;Asturias;040;Nava;5276;2593;2683
33;Asturias;041;Navia;8322;4026;4296
33;Asturias;042;Noreña;5145;2451;2694
33;Asturias;043;Onís;734;403;331
33;Asturias;044;Oviedo;219910;101749;118161
33;Asturias;045;Parres;5315;2596;2719
33;Asturias;046;Peñamellera Alta;498;265;233
33;Asturias;047;Peñamellera Baja;1227;605;622
33;Asturias;048;Pesoz;148;80;68
33;Asturias;049;Piloña;6875;3379;3496
33;Asturias;050;Ponga;572;337;235
33;Asturias;051;Pravia;7984;3861;4123
33;Asturias;052;Proaza;707;414;293
33;Asturias;053;Quirós;1187;687;500
33;Asturias;054;Regueras, Las;1839;938;901
33;Asturias;055;Ribadedeva;1741;834;907
33;Asturias;056;Ribadesella;5688;2710;2978
33;Asturias;057;Ribera de Arriba;1837;932;905
33;Asturias;058;Riosa;1848;926;922
33;Asturias;059;Salas;4900;2413;2487
33;Asturias;061;San Martín de Oscos;376;192;184
33;Asturias;060;San Martín del Rey Aurelio;15817;7564;8253
33;Asturias;063;San Tirso de Abres;421;208;213
33;Asturias;062;Santa Eulalia de Oscos;449;223;226
33;Asturias;064;Santo Adriano;273;135;138
33;Asturias;065;Sariego;1254;603;651
33;Asturias;066;Siero;51509;25220;26289
33;Asturias;067;Sobrescobio;814;433;381
33;Asturias;068;Somiedo;1093;644;449
33;Asturias;069;Soto del Barco;3800;1883;1917
33;Asturias;070;Tapia de Casariego;3726;1805;1921
33;Asturias;071;Taramundi;602;285;317
33;Asturias;072;Teverga;1554;845;709
33;Asturias;073;Tineo;9199;4655;4544
33;Asturias;034;Valdés;11394;5585;5809
33;Asturias;074;Vegadeo;3926;1886;2040
33;Asturias;075;Villanueva de Oscos;272;135;137
33;Asturias;076;Villaviciosa;14470;7180;7290
33;Asturias;077;Villayón;1180;616;564
33;Asturias;078;Yernes y Tameza;133;72;61
05;Ávila;001;Adanero;211;116;95
05;Ávila;002;Adrada, La;2539;1306;1233
05;Ávila;005;Albornos;177;93;84
05;Ávila;007;Aldeanueva de Santa Cruz;117;62;55
05;Ávila;008;Aldeaseca;228;112;116
05;Ávila;010;Aldehuela, La;153;79;74
05;Ávila;012;Amavida;127;70;57
05;Ávila;013;Arenal, El;948;477;471
05;Ávila;014;Arenas de San Pedro;6344;3073;3271
05;Ávila;015;Arevalillo;69;32;37
05;Ávila;016;Arévalo;7960;3899;4061
05;Ávila;017;Aveinte;83;48;35
05;Ávila;018;Avellaneda;26;15;11
05;Ávila;019;Ávila;58369;27784;30585
05;Ávila;021;Barco de Ávila, El;2330;1123;1207
05;Ávila;022;Barraco, El;1893;970;923
05;Ávila;023;Barromán;185;99;86
05;Ávila;024;Becedas;191;100;91
05;Ávila;025;Becedillas;80;42;38
05;Ávila;026;Bercial de Zapardiel;197;103;94
05;Ávila;027;Berlanas, Las;329;173;156
05;Ávila;029;Bernuy-Zapardiel;97;54;43
05;Ávila;030;Berrocalejo de Aragona;49;28;21
05;Ávila;033;Blascomillán;181;95;86
05;Ávila;034;Blasconuño de Matacabras;14;8;6
05;Ávila;035;Blascosancho;96;45;51
05;Ávila;036;Bohodón, El;117;60;57
05;Ávila;037;Bohoyo;232;130;102
05;Ávila;038;Bonilla de la Sierra;125;72;53
05;Ávila;039;Brabos;43;27;16
05;Ávila;040;Bularros;66;45;21
05;Ávila;041;Burgohondo;1180;623;557
05;Ávila;042;Cabezas de Alambre;161;78;83
05;Ávila;043;Cabezas del Pozo;70;37;33
05;Ávila;044;Cabezas del Villar;257;139;118
05;Ávila;045;Cabizuela;79;42;37
05;Ávila;046;Canales;42;24;18
05;Ávila;047;Candeleda;5025;2532;2493
05;Ávila;048;Cantiveros;98;57;41
05;Ávila;049;Cardeñosa;435;234;201
05;Ávila;051;Carrera, La;167;93;74
05;Ávila;052;Casas del Puerto;85;48;37
05;Ávila;053;Casasola;73;43;30
05;Ávila;054;Casavieja;1434;735;699
05;Ávila;055;Casillas;640;336;304
05;Ávila;056;Castellanos de Zapardiel;94;53;41
05;Ávila;057;Cebreros;3152;1639;1513
05;Ávila;058;Cepeda la Mora;74;42;32
05;Ávila;067;Chamartín;74;44;30
05;Ávila;059;Cillán;88;54;34
05;Ávila;060;Cisla;98;49;49
05;Ávila;061;Colilla, La;335;170;165
05;Ávila;062;Collado de Contreras;160;83;77
05;Ávila;063;Collado del Mirón;31;20;11
05;Ávila;064;Constanzana;105;59;46
05;Ávila;065;Crespos;493;266;227
05;Ávila;066;Cuevas del Valle;475;266;209
05;Ávila;903;Diego del Carpio;126;72;54
05;Ávila;069;Donjimeno;77;43;34
05;Ávila;070;Donvidas;30;18;12
05;Ávila;072;Espinosa de los Caballeros;112;59;53
05;Ávila;073;Flores de Ávila;295;164;131
05;Ávila;074;Fontiveros;749;391;358
05;Ávila;075;Fresnedilla;107;54;53
05;Ávila;076;Fresno, El;582;306;276
05;Ávila;077;Fuente el Saúz;159;86;73
05;Ávila;078;Fuentes de Año;95;56;39
05;Ávila;079;Gallegos de Altamiros;66;36;30
05;Ávila;080;Gallegos de Sobrinos;40;19;21
05;Ávila;081;Garganta del Villar;39;27;12
05;Ávila;082;Gavilanes;563;299;264
05;Ávila;083;Gemuño;152;79;73
05;Ávila;085;Gil García;38;18;20
05;Ávila;084;Gilbuena;60;36;24
05;Ávila;086;Gimialcón;75;47;28
05;Ávila;087;Gotarrendura;170;63;107
05;Ávila;088;Grandes y San Martín;25;13;12
05;Ávila;089;Guisando;510;258;252
05;Ávila;090;Gutierre-Muñoz;75;38;37
05;Ávila;092;Hernansancho;155;91;64
05;Ávila;093;Herradón de Pinares;419;232;187
05;Ávila;094;Herreros de Suso;129;69;60
05;Ávila;095;Higuera de las Dueñas;260;148;112
05;Ávila;096;Hija de Dios, La;75;45;30
05;Ávila;097;Horcajada, La;486;257;229
05;Ávila;099;Horcajo de las Torres;496;277;219
05;Ávila;100;Hornillo, El;277;147;130
05;Ávila;102;Hoyo de Pinares, El;2129;1092;1037
05;Ávila;101;Hoyocasero;281;164;117
05;Ávila;103;Hoyorredondo;61;31;30
05;Ávila;106;Hoyos de Miguel Muñoz;27;15;12
05;Ávila;104;Hoyos del Collado;33;19;14
05;Ávila;105;Hoyos del Espino;368;206;162
05;Ávila;107;Hurtumpascual;48;30;18
05;Ávila;108;Junciana;35;20;15
05;Ávila;109;Langa;480;253;227
05;Ávila;110;Lanzahíta;811;415;396
05;Ávila;113;Llanos de Tormes, Los;60;30;30
05;Ávila;112;Losar del Barco, El;107;59;48
05;Ávila;114;Madrigal de las Altas Torres;1399;711;688
05;Ávila;115;Maello;590;305;285
05;Ávila;116;Malpartida de Corneja;96;48;48
05;Ávila;117;Mamblas;200;115;85
05;Ávila;118;Mancera de Arriba;69;37;32
05;Ávila;119;Manjabálago y Ortigosa de Rioalmar;24;15;9
05;Ávila;120;Marlín;32;21;11
05;Ávila;121;Martiherrero;314;163;151
05;Ávila;122;Martínez;113;58;55
05;Ávila;123;Mediana de Voltoya;114;56;58
05;Ávila;124;Medinilla;91;41;50
05;Ávila;125;Mengamuñoz;61;31;30
05;Ávila;126;Mesegar de Corneja;57;34;23
05;Ávila;127;Mijares;694;377;317
05;Ávila;128;Mingorría;373;199;174
05;Ávila;129;Mirón, El;118;71;47
05;Ávila;130;Mironcillo;106;55;51
05;Ávila;131;Mirueña de los Infanzones;94;54;40
05;Ávila;132;Mombeltrán;942;483;459
05;Ávila;133;Monsalupe;62;33;29
05;Ávila;134;Moraleja de Matacabras;49;29;20
05;Ávila;135;Muñana;371;200;171
05;Ávila;136;Muñico;86;46;40
05;Ávila;138;Muñogalindo;326;160;166
05;Ávila;139;Muñogrande;70;39;31
05;Ávila;140;Muñomer del Peco;109;57;52
05;Ávila;141;Muñopepe;101;57;44
05;Ávila;142;Muñosancho;91;45;46
05;Ávila;143;Muñotello;58;29;29
05;Ávila;144;Narrillos del Álamo;72;38;34
05;Ávila;145;Narrillos del Rebollar;43;26;17
05;Ávila;149;Narros de Saldueña;106;60;46
05;Ávila;147;Narros del Castillo;151;84;67
05;Ávila;148;Narros del Puerto;23;12;11
05;Ávila;152;Nava de Arévalo;718;376;342
05;Ávila;153;Nava del Barco;79;43;36
05;Ávila;151;Navacepedilla de Corneja;94;48;46
05;Ávila;154;Navadijos;31;22;9
05;Ávila;155;Navaescurial;45;28;17
05;Ávila;156;Navahondilla;321;194;127
05;Ávila;157;Navalacruz;226;125;101
05;Ávila;158;Navalmoral;338;182;156
05;Ávila;159;Navalonguilla;216;112;104
05;Ávila;160;Navalosa;300;167;133
05;Ávila;161;Navalperal de Pinares;757;394;363
05;Ávila;162;Navalperal de Tormes;81;43;38
05;Ávila;163;Navaluenga;2018;996;1022
05;Ávila;164;Navaquesera;16;7;9
05;Ávila;165;Navarredonda de Gredos;430;217;213
05;Ávila;166;Navarredondilla;177;89;88
05;Ávila;167;Navarrevisca;256;143;113
05;Ávila;168;Navas del Marqués, Las;5146;2637;2509
05;Ávila;169;Navatalgordo;231;130;101
05;Ávila;170;Navatejares;51;25;26
05;Ávila;171;Neila de San Miguel;67;35;32
05;Ávila;172;Niharra;202;122;80
05;Ávila;173;Ojos-Albos;76;46;30
05;Ávila;174;Orbita;69;39;30
05;Ávila;175;Oso, El;158;87;71
05;Ávila;176;Padiernos;273;147;126
05;Ávila;177;Pajares de Adaja;138;76;62
05;Ávila;178;Palacios de Goda;389;204;185
05;Ávila;179;Papatrigo;227;113;114
05;Ávila;180;Parral, El;62;36;26
05;Ávila;181;Pascualcobo;43;28;15
05;Ávila;182;Pedro Bernardo;787;414;373
05;Ávila;183;Pedro-Rodríguez;133;69;64
05;Ávila;184;Peguerinos;275;159;116
05;Ávila;185;Peñalba de Ávila;105;59;46
05;Ávila;186;Piedrahíta;1802;874;928
05;Ávila;187;Piedralaves;2070;1025;1045
05;Ávila;188;Poveda;39;24;15
05;Ávila;189;Poyales del Hoyo;458;248;210
05;Ávila;190;Pozanco;53;30;23
05;Ávila;191;Pradosegar;109;58;51
05;Ávila;192;Puerto Castilla;107;63;44
05;Ávila;193;Rasueros;174;96;78
05;Ávila;194;Riocabado;137;79;58
05;Ávila;195;Riofrío;203;123;80
05;Ávila;196;Rivilla de Barajas;67;31;36
05;Ávila;197;Salobral;112;61;51
05;Ávila;198;Salvadiós;69;34;35
05;Ávila;199;San Bartolomé de Béjar;39;19;20
05;Ávila;200;San Bartolomé de Corneja;44;24;20
05;Ávila;201;San Bartolomé de Pinares;534;288;246
05;Ávila;206;San Esteban de los Patos;23;14;9
05;Ávila;208;San Esteban de Zapardiel;40;24;16
05;Ávila;207;San Esteban del Valle;718;370;348
05;Ávila;209;San García de Ingelmos;75;46;29
05;Ávila;901;San Juan de Gredos;247;134;113
05;Ávila;210;San Juan de la Encinilla;80;40;40
05;Ávila;211;San Juan de la Nava;459;249;210
05;Ávila;212;San Juan del Molinillo;196;111;85
05;Ávila;213;San Juan del Olmo;90;59;31
05;Ávila;214;San Lorenzo de Tormes;27;14;13
05;Ávila;215;San Martín de la Vega del Alberche;166;98;68
05;Ávila;216;San Martín del Pimpollar;186;111;75
05;Ávila;217;San Miguel de Corneja;53;30;23
05;Ávila;218;San Miguel de Serrezuela;115;61;54
05;Ávila;219;San Pascual;39;23;16
05;Ávila;220;San Pedro del Arroyo;422;224;198
05;Ávila;231;San Vicente de Arévalo;170;96;74
05;Ávila;204;Sanchidrián;714;360;354
05;Ávila;205;Sanchorreja;83;39;44
05;Ávila;222;Santa Cruz de Pinares;148;81;67
05;Ávila;221;Santa Cruz del Valle;332;173;159
05;Ávila;226;Santa María de los Caballeros;63;37;26
05;Ávila;224;Santa María del Arroyo;105;57;48
05;Ávila;225;Santa María del Berrocal;388;207;181
05;Ávila;902;Santa María del Cubillo;303;174;129
05;Ávila;227;Santa María del Tiétar;447;233;214
05;Ávila;228;Santiago del Collado;170;110;60
05;Ávila;904;Santiago del Tormes;114;66;48
05;Ávila;229;Santo Domingo de las Posadas;69;37;32
05;Ávila;230;Santo Tomé de Zabarcos;67;37;30
05;Ávila;232;Serrada, La;118;59;59
05;Ávila;233;Serranillos;243;136;107
05;Ávila;234;Sigeres;45;22;23
05;Ávila;235;Sinlabajos;143;74;69
05;Ávila;236;Solana de Ávila;110;61;49
05;Ávila;237;Solana de Rioalmar;151;92;59
05;Ávila;238;Solosancho;820;438;382
05;Ávila;239;Sotalbo;232;131;101
05;Ávila;240;Sotillo de la Adrada;4653;2310;2343
05;Ávila;241;Tiemblo, El;4180;2113;2067
05;Ávila;242;Tiñosillos;775;398;377
05;Ávila;243;Tolbaños;78;44;34
05;Ávila;244;Tormellas;37;23;14
05;Ávila;245;Tornadizos de Ávila;418;213;205
05;Ávila;247;Torre, La;230;127;103
05;Ávila;246;Tórtoles;46;26;20
05;Ávila;249;Umbrías;96;50;46
05;Ávila;251;Vadillo de la Sierra;54;36;18
05;Ávila;252;Valdecasa;59;35;24
05;Ávila;253;Vega de Santa María;77;39;38
05;Ávila;254;Velayos;214;110;104
05;Ávila;256;Villaflor;111;58;53
05;Ávila;257;Villafranca de la Sierra;129;73;56
05;Ávila;905;Villanueva de Ávila;217;112;105
05;Ávila;258;Villanueva de Gómez;115;65;50
05;Ávila;259;Villanueva del Aceral;109;54;55
05;Ávila;260;Villanueva del Campillo;101;55;46
05;Ávila;261;Villar de Corneja;35;21;14
05;Ávila;262;Villarejo del Valle;328;173;155
05;Ávila;263;Villatoro;157;93;64
05;Ávila;264;Viñegra de Moraña;53;30;23
05;Ávila;265;Vita;83;49;34
05;Ávila;266;Zapardiel de la Cañada;91;49;42
05;Ávila;267;Zapardiel de la Ribera;107;59;48
06;Badajoz;001;Acedera;826;425;401
06;Badajoz;002;Aceuchal;5478;2737;2741
06;Badajoz;003;Ahillones;863;427;436
06;Badajoz;004;Alange;1856;945;911
06;Badajoz;005;Albuera, La;2035;1066;969
06;Badajoz;006;Alburquerque;5293;2636;2657
06;Badajoz;007;Alconchel;1659;832;827
06;Badajoz;008;Alconera;743;364;379
06;Badajoz;009;Aljucén;250;138;112
06;Badajoz;010;Almendral;1239;618;621
06;Badajoz;011;Almendralejo;33855;16784;17071
06;Badajoz;012;Arroyo de San Serván;4080;2075;2005
06;Badajoz;013;Atalaya;294;154;140
06;Badajoz;014;Azuaga;7747;3827;3920
06;Badajoz;015;Badajoz;150984;73170;77814
06;Badajoz;016;Barcarrota;3483;1764;1719
06;Badajoz;017;Baterno;266;144;122
06;Badajoz;018;Benquerencia de la Serena;812;401;411
06;Badajoz;019;Berlanga;2331;1145;1186
06;Badajoz;020;Bienvenida;2081;1068;1013
06;Badajoz;021;Bodonal de la Sierra;1036;538;498
06;Badajoz;022;Burguillos del Cerro;3066;1504;1562
06;Badajoz;023;Cabeza del Buey;4808;2379;2429
06;Badajoz;024;Cabeza la Vaca;1298;666;632
06;Badajoz;025;Calamonte;6170;3056;3114
06;Badajoz;026;Calera de León;930;474;456
06;Badajoz;027;Calzadilla de los Barros;736;367;369
06;Badajoz;028;Campanario;4854;2377;2477
06;Badajoz;029;Campillo de Llerena;1343;682;661
06;Badajoz;030;Capilla;172;89;83
06;Badajoz;031;Carmonita;524;266;258
06;Badajoz;032;Carrascalejo, El;85;43;42
06;Badajoz;033;Casas de Don Pedro;1447;747;700
06;Badajoz;034;Casas de Reina;199;97;102
06;Badajoz;035;Castilblanco;915;462;453
06;Badajoz;036;Castuera;5784;2844;2940
06;Badajoz;042;Cheles;1173;569;604
06;Badajoz;037;Codosera, La;2061;1083;978
06;Badajoz;038;Cordobilla de Lácara;897;467;430
06;Badajoz;039;Coronada, La;2165;1056;1109
06;Badajoz;040;Corte de Peleas;1191;580;611
06;Badajoz;041;Cristina;551;282;269
06;Badajoz;043;Don Álvaro;775;404;371
06;Badajoz;044;Don Benito;37284;18408;18876
06;Badajoz;045;Entrín Bajo;552;285;267
06;Badajoz;046;Esparragalejo;1460;721;739
06;Badajoz;047;Esparragosa de la Serena;998;504;494
06;Badajoz;048;Esparragosa de Lares;906;449;457
06;Badajoz;049;Feria;1115;536;579
06;Badajoz;050;Fregenal de la Sierra;4836;2364;2472
06;Badajoz;051;Fuenlabrada de los Montes;1811;891;920
06;Badajoz;052;Fuente de Cantos;4687;2324;2363
06;Badajoz;053;Fuente del Arco;681;350;331
06;Badajoz;054;Fuente del Maestre;6714;3325;3389
06;Badajoz;055;Fuentes de León;2248;1107;1141
06;Badajoz;056;Garbayuela;509;268;241
06;Badajoz;057;Garlitos;565;292;273
06;Badajoz;058;Garrovilla, La;2357;1168;1189
06;Badajoz;059;Granja de Torrehermosa;1977;984;993
06;Badajoz;903;Guadiana del Caudillo;2492;1224;1268
06;Badajoz;060;Guareña;6888;3457;3431
06;Badajoz;061;Haba, La;1219;610;609
06;Badajoz;062;Helechosa de los Montes;626;351;275
06;Badajoz;063;Herrera del Duque;3489;1750;1739
06;Badajoz;064;Higuera de la Serena;936;484;452
06;Badajoz;065;Higuera de Llerena;337;173;164
06;Badajoz;066;Higuera de Vargas;1925;975;950
06;Badajoz;067;Higuera la Real;2219;1116;1103
06;Badajoz;068;Hinojosa del Valle;475;227;248
06;Badajoz;069;Hornachos;3537;1772;1765
06;Badajoz;070;Jerez de los Caballeros;9196;4521;4675
06;Badajoz;071;Lapa, La;279;141;138
06;Badajoz;073;Llera;829;428;401
06;Badajoz;074;Llerena;5743;2856;2887
06;Badajoz;072;Lobón;2756;1406;1350
06;Badajoz;075;Magacela;523;269;254
06;Badajoz;076;Maguilla;957;473;484
06;Badajoz;077;Malcocinado;356;194;162
06;Badajoz;078;Malpartida de la Serena;543;285;258
06;Badajoz;079;Manchita;764;382;382
06;Badajoz;080;Medellín;2275;1147;1128
06;Badajoz;081;Medina de las Torres;1176;614;562
06;Badajoz;082;Mengabril;498;272;226
06;Badajoz;083;Mérida;59548;29000;30548
06;Badajoz;084;Mirandilla;1262;633;629
06;Badajoz;085;Monesterio;4216;2150;2066
06;Badajoz;086;Montemolín;1361;648;713
06;Badajoz;087;Monterrubio de la Serena;2326;1148;1178
06;Badajoz;088;Montijo;15504;7652;7852
06;Badajoz;089;Morera, La;714;366;348
06;Badajoz;090;Nava de Santiago, La;926;468;458
06;Badajoz;091;Navalvillar de Pela;4403;2218;2185
06;Badajoz;092;Nogales;658;331;327
06;Badajoz;093;Oliva de la Frontera;5086;2550;2536
06;Badajoz;094;Oliva de Mérida;1725;874;851
06;Badajoz;095;Olivenza;11912;5942;5970
06;Badajoz;096;Orellana de la Sierra;244;121;123
06;Badajoz;097;Orellana la Vieja;2641;1363;1278
06;Badajoz;098;Palomas;671;335;336
06;Badajoz;099;Parra, La;1327;686;641
06;Badajoz;100;Peñalsordo;896;437;459
06;Badajoz;101;Peraleda del Zaucejo;507;255;252
06;Badajoz;102;Puebla de Alcocer;1212;600;612
06;Badajoz;103;Puebla de la Calzada;5834;2923;2911
06;Badajoz;104;Puebla de la Reina;724;360;364
06;Badajoz;107;Puebla de Obando;1839;936;903
06;Badajoz;108;Puebla de Sancho Pérez;2676;1350;1326
06;Badajoz;105;Puebla del Maestre;670;344;326
06;Badajoz;106;Puebla del Prior;480;247;233
06;Badajoz;902;Pueblonuevo del Guadiana;2008;1006;1002
06;Badajoz;109;Quintana de la Serena;4574;2308;2266
06;Badajoz;110;Reina;150;76;74
06;Badajoz;111;Rena;610;310;300
06;Badajoz;112;Retamal de Llerena;436;223;213
06;Badajoz;113;Ribera del Fresno;3256;1622;1634
06;Badajoz;114;Risco;132;65;67
06;Badajoz;115;Roca de la Sierra, La;1455;711;744
06;Badajoz;116;Salvaleón;1721;861;860
06;Badajoz;117;Salvatierra de los Barros;1607;786;821
06;Badajoz;119;San Pedro de Mérida;838;431;407
06;Badajoz;123;San Vicente de Alcántara;5377;2714;2663
06;Badajoz;118;Sancti-Spíritus;165;95;70
06;Badajoz;120;Santa Amalia;3975;2006;1969
06;Badajoz;121;Santa Marta;4124;2074;2050
06;Badajoz;122;Santos de Maimona, Los;8075;4073;4002
06;Badajoz;124;Segura de León;1851;925;926
06;Badajoz;125;Siruela;1861;943;918
06;Badajoz;126;Solana de los Barros;2601;1301;1300
06;Badajoz;127;Talarrubias;3406;1697;1709
06;Badajoz;128;Talavera la Real;5314;2649;2665
06;Badajoz;129;Táliga;678;336;342
06;Badajoz;130;Tamurejo;212;107;105
06;Badajoz;131;Torre de Miguel Sesmero;1246;637;609
06;Badajoz;132;Torremayor;949;459;490
06;Badajoz;133;Torremejía;2257;1168;1089
06;Badajoz;134;Trasierra;625;330;295
06;Badajoz;135;Trujillanos;1376;704;672
06;Badajoz;136;Usagre;1751;866;885
06;Badajoz;137;Valdecaballeros;1065;552;513
06;Badajoz;901;Valdelacalzada;2721;1384;1337
06;Badajoz;138;Valdetorres;1179;573;606
06;Badajoz;139;Valencia de las Torres;540;284;256
06;Badajoz;140;Valencia del Mombuey;725;372;353
06;Badajoz;141;Valencia del Ventoso;1960;976;984
06;Badajoz;146;Valle de la Serena;1172;586;586
06;Badajoz;147;Valle de Matamoros;363;178;185
06;Badajoz;148;Valle de Santa Ana;1143;563;580
06;Badajoz;142;Valverde de Burguillos;273;145;128
06;Badajoz;143;Valverde de Leganés;4167;2088;2079
06;Badajoz;144;Valverde de Llerena;570;284;286
06;Badajoz;145;Valverde de Mérida;1047;534;513
06;Badajoz;149;Villafranca de los Barros;12673;6230;6443
06;Badajoz;150;Villagarcía de la Torre;906;464;442
06;Badajoz;151;Villagonzalo;1234;599;635
06;Badajoz;152;Villalba de los Barros;1475;743;732
06;Badajoz;153;Villanueva de la Serena;25752;12530;13222
06;Badajoz;154;Villanueva del Fresno;3364;1678;1686
06;Badajoz;156;Villar de Rena;1353;695;658
06;Badajoz;155;Villar del Rey;2106;1126;980
06;Badajoz;157;Villarta de los Montes;423;214;209
06;Badajoz;158;Zafra;16810;8095;8715
06;Badajoz;159;Zahínos;2774;1377;1397
06;Badajoz;160;Zalamea de la Serena;3545;1787;1758
06;Badajoz;162;Zarza, La;3402;1716;1686
06;Badajoz;161;Zarza-Capilla;310;156;154
07;Balears, Illes;002;Alaior;9467;4798;4669
07;Balears, Illes;001;Alaró;5617;2717;2900
07;Balears, Illes;003;Alcúdia;20819;10552;10267
07;Balears, Illes;004;Algaida;5793;2941;2852
07;Balears, Illes;005;Andratx;11433;5716;5717
07;Balears, Illes;901;Ariany;902;469;433
07;Balears, Illes;006;Artà;7984;4010;3974
07;Balears, Illes;007;Banyalbufar;523;279;244
07;Balears, Illes;008;Binissalem;8756;4380;4376
07;Balears, Illes;009;Búger;1087;567;520
07;Balears, Illes;010;Bunyola;6895;3364;3531
07;Balears, Illes;011;Calvià;51710;26010;25700
07;Balears, Illes;012;Campanet;2648;1343;1305
07;Balears, Illes;013;Campos;11283;5631;5652
07;Balears, Illes;014;Capdepera;12158;6189;5969
07;Balears, Illes;064;Castell, Es;7572;3818;3754
07;Balears, Illes;015;Ciutadella de Menorca;30588;15242;15346
07;Balears, Illes;016;Consell;4125;2067;2058
07;Balears, Illes;017;Costitx;1329;659;670
07;Balears, Illes;018;Deià;630;309;321
07;Balears, Illes;026;Eivissa;51128;25766;25362
07;Balears, Illes;019;Escorca;208;128;80
07;Balears, Illes;020;Esporles;5113;2526;2587
07;Balears, Illes;021;Estellencs;327;175;152
07;Balears, Illes;022;Felanitx;18202;9191;9011
07;Balears, Illes;023;Ferreries;4908;2460;2448
07;Balears, Illes;024;Formentera;11904;6228;5676
07;Balears, Illes;025;Fornalutx;679;343;336
07;Balears, Illes;027;Inca;33679;16913;16766
07;Balears, Illes;028;Lloret de Vistalegre;1437;734;703
07;Balears, Illes;029;Lloseta;6122;3076;3046
07;Balears, Illes;030;Llubí;2298;1143;1155
07;Balears, Illes;031;Llucmajor;37752;19173;18579
07;Balears, Illes;033;Manacor;44527;22314;22213
07;Balears, Illes;034;Mancor de la Vall;1528;772;756
07;Balears, Illes;032;Maó-Mahón;29592;14436;15156
07;Balears, Illes;035;Maria de la Salut;2245;1162;1083
07;Balears, Illes;036;Marratxí;37724;18993;18731
07;Balears, Illes;037;Mercadal, Es;5316;2707;2609
07;Balears, Illes;902;Migjorn Gran, Es;1463;726;737
07;Balears, Illes;038;Montuïri;2987;1508;1479
07;Balears, Illes;039;Muro;7394;3763;3631
07;Balears, Illes;040;Palma ;422587;206654;215933
07;Balears, Illes;041;Petra;2942;1459;1483
07;Balears, Illes;044;Pobla, Sa;13764;6970;6794
07;Balears, Illes;042;Pollença;16658;8283;8375
07;Balears, Illes;043;Porreres;5576;2852;2724
07;Balears, Illes;045;Puigpunyent;2044;1008;1036
07;Balears, Illes;059;Salines, Ses;5096;2594;2502
07;Balears, Illes;046;Sant Antoni de Portmany;27033;14205;12828
07;Balears, Illes;049;Sant Joan;2145;1059;1086
07;Balears, Illes;050;Sant Joan de Labritja;6576;3374;3202
07;Balears, Illes;048;Sant Josep de sa Talaia;27732;14338;13394
07;Balears, Illes;051;Sant Llorenç des Cardassar;8742;4342;4400
07;Balears, Illes;052;Sant Lluís;6735;3424;3311
07;Balears, Illes;053;Santa Eugènia;1641;814;827
07;Balears, Illes;054;Santa Eulària des Riu;39358;19894;19464
07;Balears, Illes;055;Santa Margalida;12797;6595;6202
07;Balears, Illes;056;Santa María del Camí;7486;3742;3744
07;Balears, Illes;057;Santanyí;12373;6236;6137
07;Balears, Illes;058;Selva;4080;1994;2086
07;Balears, Illes;047;Sencelles;3370;1692;1678
07;Balears, Illes;060;Sineu;4030;2002;2028
07;Balears, Illes;061;Sóller;13634;6803;6831
07;Balears, Illes;062;Son Servera;11817;5879;5938
07;Balears, Illes;063;Valldemossa;2009;1016;993
07;Balears, Illes;065;Vilafranca de Bonany;3466;1771;1695
08;Barcelona;001;Abrera;12538;6325;6213
08;Barcelona;002;Aguilar de Segarra;282;148;134
08;Barcelona;014;Aiguafreda;2512;1221;1291
08;Barcelona;003;Alella;9904;4838;5066
08;Barcelona;004;Alpens;261;137;124
08;Barcelona;005;Ametlla del Vallès, L';8646;4358;4288
08;Barcelona;006;Arenys de Mar;15941;7761;8180
08;Barcelona;007;Arenys de Munt;9121;4591;4530
08;Barcelona;008;Argençola;219;113;106
08;Barcelona;009;Argentona;12536;6197;6339
08;Barcelona;010;Artés;5762;2911;2851
08;Barcelona;011;Avià;2220;1113;1107
08;Barcelona;012;Avinyó;2289;1137;1152
08;Barcelona;013;Avinyonet del Penedès;1697;899;798
08;Barcelona;015;Badalona;223166;110018;113148
08;Barcelona;904;Badia del Vallès;13415;6568;6847
08;Barcelona;016;Bagà;2140;1061;1079
08;Barcelona;017;Balenyà;3840;1921;1919
08;Barcelona;018;Balsareny;3192;1576;1616
08;Barcelona;252;Barberà del Vallès;33334;16395;16939
08;Barcelona;019;Barcelona;1664182;790708;873474
08;Barcelona;020;Begues;7300;3650;3650
08;Barcelona;021;Bellprat;64;41;23
08;Barcelona;022;Berga;16760;8315;8445
08;Barcelona;023;Bigues i Riells;9358;4779;4579
08;Barcelona;024;Borredà;464;257;207
08;Barcelona;025;Bruc, El;2110;1128;982
08;Barcelona;026;Brull, El;258;142;116
08;Barcelona;027;Cabanyes, Les;979;499;480
08;Barcelona;028;Cabrera d'Anoia;1482;795;687
08;Barcelona;029;Cabrera de Mar;4747;2381;2366
08;Barcelona;030;Cabrils;7432;3667;3765
08;Barcelona;031;Calaf;3656;1843;1813
08;Barcelona;034;Calders;1045;530;515
08;Barcelona;033;Caldes de Montbui;17812;8873;8939
08;Barcelona;032;Caldes d'Estrac;3021;1442;1579
08;Barcelona;035;Calella;19277;9399;9878
08;Barcelona;037;Calldetenes;2513;1281;1232
08;Barcelona;038;Callús;2129;1053;1076
08;Barcelona;036;Calonge de Segarra;188;92;96
08;Barcelona;039;Campins;541;283;258
08;Barcelona;040;Canet de Mar;14865;7294;7571
08;Barcelona;041;Canovelles;16829;8693;8136
08;Barcelona;042;Cànoves i Samalús;3156;1611;1545
08;Barcelona;043;Canyelles;4699;2430;2269
08;Barcelona;044;Capellades;5342;2665;2677
08;Barcelona;045;Capolat;84;39;45
08;Barcelona;046;Cardedeu;18424;8975;9449
08;Barcelona;047;Cardona;4639;2266;2373
08;Barcelona;048;Carme;785;411;374
08;Barcelona;049;Casserres;1588;803;785
08;Barcelona;057;Castell de l'Areny;67;37;30
08;Barcelona;052;Castellar de n'Hug;156;84;72
08;Barcelona;050;Castellar del Riu;176;99;77
08;Barcelona;051;Castellar del Vallès;24488;12089;12399
08;Barcelona;053;Castellbell i el Vilar;3719;1901;1818
08;Barcelona;054;Castellbisbal;12539;6307;6232
08;Barcelona;055;Castellcir;742;397;345
08;Barcelona;056;Castelldefels;67460;33162;34298
08;Barcelona;058;Castellet i la Gornal;2382;1239;1143
08;Barcelona;060;Castellfollit de Riubregós;162;91;71
08;Barcelona;059;Castellfollit del Boix;447;228;219
08;Barcelona;061;Castellgalí;2119;1102;1017
08;Barcelona;062;Castellnou de Bages;1437;770;667
08;Barcelona;063;Castellolí;626;302;324
08;Barcelona;064;Castellterçol;2548;1275;1273
08;Barcelona;065;Castellví de la Marca;1575;795;780
08;Barcelona;066;Castellví de Rosanes;1933;949;984
08;Barcelona;067;Centelles;7513;3696;3817
08;Barcelona;268;Cercs;1150;568;582
08;Barcelona;266;Cerdanyola del Vallès;57855;28284;29571
08;Barcelona;068;Cervelló;9077;4571;4506
08;Barcelona;069;Collbató;4544;2359;2185
08;Barcelona;070;Collsuspina;359;183;176
08;Barcelona;071;Copons;321;157;164
08;Barcelona;072;Corbera de Llobregat;14882;7454;7428
08;Barcelona;073;Cornellà de Llobregat;89936;43622;46314
08;Barcelona;074;Cubelles;15770;7944;7826
08;Barcelona;075;Dosrius;5652;2881;2771
08;Barcelona;076;Esparreguera;22302;11273;11029
08;Barcelona;077;Esplugues de Llobregat;47150;22461;24689
08;Barcelona;078;Espunyola, L';242;120;122
08;Barcelona;254;Esquirol, L';2186;1098;1088
08;Barcelona;079;Estany, L';408;215;193
08;Barcelona;134;Figaró-Montmany;1142;559;583
08;Barcelona;080;Fígols;43;26;17
08;Barcelona;082;Fogars de la Selva;1469;757;712
08;Barcelona;081;Fogars de Montclús;475;249;226
08;Barcelona;083;Folgueroles;2265;1150;1115
08;Barcelona;084;Fonollosa;1459;752;707
08;Barcelona;085;Font-rubí;1414;744;670
08;Barcelona;086;Franqueses del Vallès, Les;20364;10331;10033
08;Barcelona;090;Gaià;183;98;85
08;Barcelona;087;Gallifa;167;89;78
08;Barcelona;088;Garriga, La;16668;8056;8612
08;Barcelona;089;Gavà;47057;23022;24035
08;Barcelona;091;Gelida;7670;3842;3828
08;Barcelona;092;Gironella;4946;2461;2485
08;Barcelona;093;Gisclareny;26;16;10
08;Barcelona;094;Granada, La;2208;1097;1111
08;Barcelona;095;Granera;77;52;25
08;Barcelona;096;Granollers;62419;30891;31528
08;Barcelona;097;Gualba;1548;794;754
08;Barcelona;099;Guardiola de Berguedà;941;492;449
08;Barcelona;100;Gurb;2713;1399;1314
08;Barcelona;101;Hospitalet de Llobregat, L';269382;130289;139093
08;Barcelona;162;Hostalets de Pierola, Els;2980;1518;1462
08;Barcelona;102;Igualada;40742;20073;20669
08;Barcelona;103;Jorba;833;429;404
08;Barcelona;104;Llacuna, La;903;493;410
08;Barcelona;105;Llagosta, La;13587;6691;6896
08;Barcelona;107;Lliçà d'Amunt;15469;7906;7563
08;Barcelona;108;Lliçà de Vall;6497;3319;3178
08;Barcelona;106;Llinars del Vallès;10018;4991;5027
08;Barcelona;109;Lluçà;276;135;141
08;Barcelona;110;Malgrat de Mar;18772;9329;9443
08;Barcelona;111;Malla;272;138;134
08;Barcelona;112;Manlleu;20912;10512;10400
08;Barcelona;113;Manresa;78245;38335;39910
08;Barcelona;242;Marganell;266;127;139
08;Barcelona;114;Martorell;28772;14655;14117
08;Barcelona;115;Martorelles;4820;2435;2385
08;Barcelona;116;Masies de Roda, Les;719;368;351
08;Barcelona;117;Masies de Voltregà, Les;3132;1549;1583
08;Barcelona;118;Masnou, El;23831;11524;12307
08;Barcelona;119;Masquefa;9402;4758;4644
08;Barcelona;120;Matadepera;9496;4756;4740
08;Barcelona;121;Mataró;129661;64476;65185
08;Barcelona;122;Mediona;2369;1192;1177
08;Barcelona;138;Moià;6383;3281;3102
08;Barcelona;123;Molins de Rei;25940;12639;13301
08;Barcelona;124;Mollet del Vallès;51600;25410;26190
08;Barcelona;128;Monistrol de Calders;702;366;336
08;Barcelona;127;Monistrol de Montserrat;3139;1603;1536
08;Barcelona;125;Montcada i Reixac;36803;18148;18655
08;Barcelona;130;Montclar;139;72;67
08;Barcelona;131;Montesquiu;1030;513;517
08;Barcelona;126;Montgat;12200;6029;6171
08;Barcelona;132;Montmajor;469;232;237
08;Barcelona;133;Montmaneu;151;81;70
08;Barcelona;135;Montmeló;8831;4320;4511
08;Barcelona;136;Montornès del Vallès;16644;8390;8254
08;Barcelona;137;Montseny;351;187;164
08;Barcelona;129;Muntanyola;632;328;304
08;Barcelona;139;Mura;220;117;103
08;Barcelona;140;Navarcles;6057;2958;3099
08;Barcelona;141;Navàs;6018;2987;3031
08;Barcelona;142;Nou de Berguedà, La;162;84;78
08;Barcelona;143;Òdena;3668;1881;1787
08;Barcelona;145;Olèrdola;3768;1955;1813
08;Barcelona;146;Olesa de Bonesvalls;1840;968;872
08;Barcelona;147;Olesa de Montserrat;24144;12058;12086
08;Barcelona;148;Olivella;3935;2054;1881
08;Barcelona;149;Olost;1202;586;616
08;Barcelona;144;Olvan;858;419;439
08;Barcelona;150;Orís;322;164;158
08;Barcelona;151;Oristà;549;282;267
08;Barcelona;152;Orpí;151;79;72
08;Barcelona;153;Òrrius;758;387;371
08;Barcelona;154;Pacs del Penedès;918;463;455
08;Barcelona;155;Palafolls;9613;4814;4799
08;Barcelona;156;Palau-solità i Plegamans;14892;7289;7603
08;Barcelona;157;Pallejà;11622;5794;5828
08;Barcelona;905;Palma de Cervelló, La;2992;1475;1517
08;Barcelona;158;Papiol, El;4172;2063;2109
08;Barcelona;159;Parets del Vallès;19071;9518;9553
08;Barcelona;160;Perafita;405;208;197
08;Barcelona;161;Piera;16134;8253;7881
08;Barcelona;163;Pineda de Mar;27984;13940;14044
08;Barcelona;164;Pla del Penedès, El;1275;638;637
08;Barcelona;165;Pobla de Claramunt, La;2185;1110;1075
08;Barcelona;166;Pobla de Lillet, La;1093;531;562
08;Barcelona;167;Polinyà;8504;4320;4184
08;Barcelona;182;Pont de Vilomara i Rocafort, El;3907;2007;1900
08;Barcelona;168;Pontons;528;283;245
08;Barcelona;169;Prat de Llobregat, El;65385;31951;33434
08;Barcelona;171;Prats de Lluçanès;2604;1305;1299
08;Barcelona;170;Prats de Rei, Els;537;286;251
08;Barcelona;230;Premià de Dalt;10441;5201;5240
08;Barcelona;172;Premià de Mar;28531;13913;14618
08;Barcelona;174;Puigdàlber;524;249;275
08;Barcelona;175;Puig-reig;4295;2135;2160
08;Barcelona;176;Pujalt;210;118;92
08;Barcelona;177;Quar, La;49;26;23
08;Barcelona;178;Rajadell;534;273;261
08;Barcelona;179;Rellinars;809;417;392
08;Barcelona;180;Ripollet;39179;19396;19783
08;Barcelona;181;Roca del Vallès, La;10754;5356;5398
08;Barcelona;183;Roda de Ter;6490;3235;3255
08;Barcelona;184;Rubí;78591;38889;39702
08;Barcelona;185;Rubió;239;134;105
08;Barcelona;901;Rupit i Pruit;271;132;139
08;Barcelona;187;Sabadell;216520;105388;111132
08;Barcelona;188;Sagàs;145;77;68
08;Barcelona;190;Saldes;278;159;119
08;Barcelona;191;Sallent;6735;3260;3475
08;Barcelona;194;Sant Adrià de Besòs;37447;18369;19078
08;Barcelona;195;Sant Agustí de Lluçanès;89;44;45
08;Barcelona;196;Sant Andreu de la Barca;27569;13644;13925
08;Barcelona;197;Sant Andreu de Llavaneres;11133;5513;5620
08;Barcelona;198;Sant Antoni de Vilamajor;6208;3066;3142
08;Barcelona;199;Sant Bartomeu del Grau;884;475;409
08;Barcelona;200;Sant Boi de Llobregat;84500;41235;43265
08;Barcelona;201;Sant Boi de Lluçanès;580;293;287
08;Barcelona;203;Sant Cebrià de Vallalta;3438;1791;1647
08;Barcelona;202;Sant Celoni;18136;9032;9104
08;Barcelona;204;Sant Climent de Llobregat;4160;2097;2063
08;Barcelona;205;Sant Cugat del Vallès;92977;45216;47761
08;Barcelona;206;Sant Cugat Sesgarrigues;1009;491;518
08;Barcelona;207;Sant Esteve de Palautordera;2864;1412;1452
08;Barcelona;208;Sant Esteve Sesrovires;7696;3862;3834
08;Barcelona;210;Sant Feliu de Codines;6363;3232;3131
08;Barcelona;211;Sant Feliu de Llobregat;45467;22104;23363
08;Barcelona;212;Sant Feliu Sasserra;605;319;286
08;Barcelona;209;Sant Fost de Campsentelles;8853;4408;4445
08;Barcelona;213;Sant Fruitós de Bages;8837;4348;4489
08;Barcelona;215;Sant Hipòlit de Voltregà;3540;1765;1775
08;Barcelona;193;Sant Iscle de Vallalta;1342;712;630
08;Barcelona;216;Sant Jaume de Frontanyà;30;18;12
08;Barcelona;218;Sant Joan de Vilatorrada;10998;5521;5477
08;Barcelona;217;Sant Joan Despí;34267;16692;17575
08;Barcelona;903;Sant Julià de Cerdanyola;229;127;102
08;Barcelona;220;Sant Julià de Vilatorta;3140;1559;1581
08;Barcelona;221;Sant Just Desvern;18670;8951;9719
08;Barcelona;222;Sant Llorenç d'Hortons;2428;1234;1194
08;Barcelona;223;Sant Llorenç Savall;2417;1216;1201
08;Barcelona;225;Sant Martí d'Albars;114;57;57
08;Barcelona;224;Sant Martí de Centelles;1184;609;575
08;Barcelona;226;Sant Martí de Tous;1228;634;594
08;Barcelona;227;Sant Martí Sarroca;3261;1605;1656
08;Barcelona;228;Sant Martí Sesgueioles;342;178;164
08;Barcelona;229;Sant Mateu de Bages;608;313;295
08;Barcelona;231;Sant Pere de Ribes;31111;15456;15655
08;Barcelona;232;Sant Pere de Riudebitlles;2380;1191;1189
08;Barcelona;233;Sant Pere de Torelló;2470;1276;1194
08;Barcelona;234;Sant Pere de Vilamajor;4544;2279;2265
08;Barcelona;189;Sant Pere Sallavinera;151;83;68
08;Barcelona;235;Sant Pol de Mar;5428;2690;2738
08;Barcelona;236;Sant Quintí de Mediona;2317;1192;1125
08;Barcelona;237;Sant Quirze de Besora;2154;1041;1113
08;Barcelona;238;Sant Quirze del Vallès;20195;9901;10294
08;Barcelona;239;Sant Quirze Safaja;631;346;285
08;Barcelona;240;Sant Sadurní d'Anoia;12841;6328;6513
08;Barcelona;241;Sant Sadurní d'Osormort;76;46;30
08;Barcelona;098;Sant Salvador de Guardiola;3221;1659;1562
08;Barcelona;262;Sant Vicenç de Castellet;9767;4892;4875
08;Barcelona;264;Sant Vicenç de Montalt;6452;3245;3207
08;Barcelona;265;Sant Vicenç de Torelló;2058;1023;1035
08;Barcelona;263;Sant Vicenç dels Horts;28268;14044;14224
08;Barcelona;243;Santa Cecília de Voltregà;182;100;82
08;Barcelona;244;Santa Coloma de Cervelló;8268;4037;4231
08;Barcelona;245;Santa Coloma de Gramenet;120443;59527;60916
08;Barcelona;246;Santa Eugènia de Berga;2278;1161;1117
08;Barcelona;247;Santa Eulàlia de Riuprimer;1383;700;683
08;Barcelona;248;Santa Eulàlia de Ronçana;7426;3729;3697
08;Barcelona;249;Santa Fe del Penedès;367;180;187
08;Barcelona;250;Santa Margarida de Montbui;10225;5148;5077
08;Barcelona;251;Santa Margarida i els Monjos;7676;3919;3757
08;Barcelona;253;Santa Maria de Besora;161;84;77
08;Barcelona;256;Santa Maria de Martorelles;890;446;444
08;Barcelona;255;Santa Maria de Merlès;184;89;95
08;Barcelona;257;Santa Maria de Miralles;119;64;55
08;Barcelona;259;Santa Maria de Palautordera;9630;4870;4760
08;Barcelona;258;Santa Maria d'Oló;1024;518;506
08;Barcelona;260;Santa Perpètua de Mogoda;25999;13083;12916
08;Barcelona;261;Santa Susanna;3548;1775;1773
08;Barcelona;192;Santpedor;7604;3789;3815
08;Barcelona;267;Sentmenat;9235;4681;4554
08;Barcelona;269;Seva;3544;1806;1738
08;Barcelona;270;Sitges;29553;14811;14742
08;Barcelona;271;Sobremunt;78;34;44
08;Barcelona;272;Sora;212;121;91
08;Barcelona;273;Subirats;3104;1619;1485
08;Barcelona;274;Súria;5948;2894;3054
08;Barcelona;276;Tagamanent;318;161;157
08;Barcelona;277;Talamanca;209;118;91
08;Barcelona;278;Taradell;6640;3326;3314
08;Barcelona;275;Tavèrnoles;322;166;156
08;Barcelona;280;Tavertet;105;52;53
08;Barcelona;281;Teià;6427;3153;3274
08;Barcelona;279;Terrassa;223627;109948;113679
08;Barcelona;282;Tiana;8945;4305;4640
08;Barcelona;283;Tona;8356;4156;4200
08;Barcelona;284;Tordera;17519;8870;8649
08;Barcelona;285;Torelló;14400;7171;7229
08;Barcelona;286;Torre de Claramunt, La;3741;1935;1806
08;Barcelona;287;Torrelavit;1422;721;701
08;Barcelona;288;Torrelles de Foix;2398;1281;1117
08;Barcelona;289;Torrelles de Llobregat;6073;3021;3052
08;Barcelona;290;Ullastrell;2089;1053;1036
08;Barcelona;291;Vacarisses;6832;3500;3332
08;Barcelona;292;Vallbona d'Anoia;1357;703;654
08;Barcelona;293;Vallcebre;249;140;109
08;Barcelona;294;Vallgorguina;2988;1513;1475
08;Barcelona;295;Vallirana;15312;7691;7621
08;Barcelona;296;Vallromanes;2558;1322;1236
08;Barcelona;297;Veciana;175;95;80
08;Barcelona;298;Vic;47630;24098;23532
08;Barcelona;299;Vilada;419;221;198
08;Barcelona;301;Viladecans;67197;33231;33966
08;Barcelona;300;Viladecavalls;7545;3760;3785
08;Barcelona;305;Vilafranca del Penedès;40154;19516;20638
08;Barcelona;306;Vilalba Sasserra;753;384;369
08;Barcelona;303;Vilanova de Sau;312;148;164
08;Barcelona;302;Vilanova del Camí;12596;6292;6304
08;Barcelona;902;Vilanova del Vallès;5503;2781;2722
08;Barcelona;307;Vilanova i la Geltrú;67733;32752;34981
08;Barcelona;214;Vilassar de Dalt;9072;4464;4608
08;Barcelona;219;Vilassar de Mar;21035;10186;10849
08;Barcelona;304;Vilobí del Penedès;1102;570;532
08;Barcelona;308;Viver i Serrateix;172;88;84
48;Bizkaia;001;Abadiño;7658;3862;3796
48;Bizkaia;002;Abanto y Ciérvana-Abanto Zierbena;9471;4692;4779
48;Bizkaia;911;Ajangiz;464;242;222
48;Bizkaia;912;Alonsotegi;2879;1421;1458
48;Bizkaia;003;Amorebieta-Etxano;19529;9626;9903
48;Bizkaia;004;Amoroto;416;210;206
48;Bizkaia;005;Arakaldo;165;81;84
48;Bizkaia;006;Arantzazu;408;199;209
48;Bizkaia;093;Areatza;1216;586;630
48;Bizkaia;009;Arrankudiaga;965;471;494
48;Bizkaia;914;Arratzu;413;198;215
48;Bizkaia;010;Arrieta;580;293;287
48;Bizkaia;011;Arrigorriaga;12225;5953;6272
48;Bizkaia;023;Artea;733;371;362
48;Bizkaia;008;Artzentales;699;367;332
48;Bizkaia;091;Atxondo;1335;678;657
48;Bizkaia;070;Aulesti;657;323;334
48;Bizkaia;012;Bakio;2676;1356;1320
48;Bizkaia;090;Balmaseda;7722;3725;3997
48;Bizkaia;013;Barakaldo;101486;48963;52523
48;Bizkaia;014;Barrika;1533;766;767
48;Bizkaia;015;Basauri;40847;19745;21102
48;Bizkaia;092;Bedia;1061;505;556
48;Bizkaia;016;Berango;7217;3523;3694
48;Bizkaia;017;Bermeo;16864;8293;8571
48;Bizkaia;018;Berriatua;1251;685;566
48;Bizkaia;019;Berriz;4580;2287;2293
48;Bizkaia;020;Bilbao;350184;165493;184691
48;Bizkaia;021;Busturia;1632;818;814
48;Bizkaia;901;Derio;6730;3294;3436
48;Bizkaia;026;Dima;1448;746;702
48;Bizkaia;027;Durango;30118;14703;15415
48;Bizkaia;028;Ea;808;426;382
48;Bizkaia;031;Elantxobe;347;177;170
48;Bizkaia;032;Elorrio;7375;3622;3753
48;Bizkaia;902;Erandio;24530;11884;12646
48;Bizkaia;033;Ereño;260;148;112
48;Bizkaia;034;Ermua;15847;7883;7964
48;Bizkaia;079;Errigoiti;486;262;224
48;Bizkaia;029;Etxebarri;11691;5840;5851
48;Bizkaia;030;Etxebarria;782;395;387
48;Bizkaia;906;Forua;907;446;461
48;Bizkaia;035;Fruiz;552;277;275
48;Bizkaia;036;Galdakao;29427;14536;14891
48;Bizkaia;037;Galdames;838;449;389
48;Bizkaia;038;Gamiz-Fika;1362;678;684
48;Bizkaia;039;Garai;325;160;165
48;Bizkaia;040;Gatika;1665;832;833
48;Bizkaia;041;Gautegiz Arteaga;808;410;398
48;Bizkaia;046;Gernika-Lumo;17105;8227;8878
48;Bizkaia;044;Getxo;77770;36387;41383
48;Bizkaia;047;Gizaburuaga;197;100;97
48;Bizkaia;042;Gordexola;1697;865;832
48;Bizkaia;043;Gorliz;5891;2908;2983
48;Bizkaia;045;Güeñes;6736;3262;3474
48;Bizkaia;048;Ibarrangelu;629;318;311
48;Bizkaia;094;Igorre;4337;2133;2204
48;Bizkaia;049;Ispaster;729;385;344
48;Bizkaia;910;Iurreta;3665;1802;1863
48;Bizkaia;050;Izurtza;252;159;93
48;Bizkaia;022;Karrantza Harana/Valle de Carranza;2803;1472;1331
48;Bizkaia;907;Kortezubi;442;214;228
48;Bizkaia;051;Lanestosa;253;136;117
48;Bizkaia;052;Larrabetzu;2037;986;1051
48;Bizkaia;053;Laukiz;1227;600;627
48;Bizkaia;054;Leioa;32013;15604;16409
48;Bizkaia;057;Lekeitio;7317;3622;3695
48;Bizkaia;055;Lemoa;3504;1744;1760
48;Bizkaia;056;Lemoiz;1258;662;596
48;Bizkaia;081;Lezama;2445;1220;1225
48;Bizkaia;903;Loiu;2394;1220;1174
48;Bizkaia;058;Mallabia;1173;600;573
48;Bizkaia;059;Mañaria;522;260;262
48;Bizkaia;060;Markina-Xemein;5068;2560;2508
48;Bizkaia;061;Maruri-Jatabe;978;503;475
48;Bizkaia;062;Mendata;380;197;183
48;Bizkaia;063;Mendexa;425;213;212
48;Bizkaia;064;Meñaka;754;396;358
48;Bizkaia;066;Morga;405;217;188
48;Bizkaia;068;Mundaka;1845;888;957
48;Bizkaia;069;Mungia;17665;8603;9062
48;Bizkaia;007;Munitibar-Arbatzegi Gerrikaitz;473;263;210
48;Bizkaia;908;Murueta;319;165;154
48;Bizkaia;071;Muskiz;7536;3671;3865
48;Bizkaia;067;Muxika;1468;768;700
48;Bizkaia;909;Nabarniz;246;122;124
48;Bizkaia;073;Ondarroa;8395;4193;4202
48;Bizkaia;075;Orozko;2650;1303;1347
48;Bizkaia;083;Ortuella;8385;4090;4295
48;Bizkaia;072;Otxandio;1330;682;648
48;Bizkaia;077;Plentzia;4353;2125;2228
48;Bizkaia;078;Portugalete;45746;21882;23864
48;Bizkaia;082;Santurtzi;46069;22148;23921
48;Bizkaia;084;Sestao;27452;13270;14182
48;Bizkaia;904;Sondika;4547;2199;2348
48;Bizkaia;085;Sopela;14120;6978;7142
48;Bizkaia;086;Sopuerta;2570;1281;1289
48;Bizkaia;076;Sukarrieta;331;169;162
48;Bizkaia;087;Trucios-Turtzioz;509;266;243
48;Bizkaia;088;Ubide;164;87;77
48;Bizkaia;065;Ugao-Miraballes;4148;2089;2059
48;Bizkaia;089;Urduliz;4712;2347;2365
48;Bizkaia;074;Urduña/Orduña;4192;2164;2028
48;Bizkaia;080;Valle de Trápaga-Trapagaran;11975;5814;6161
48;Bizkaia;095;Zaldibar;3045;1533;1512
48;Bizkaia;096;Zalla;8450;4180;4270
48;Bizkaia;905;Zamudio;3275;1620;1655
48;Bizkaia;097;Zaratamo;1631;804;827
48;Bizkaia;024;Zeanuri;1245;636;609
48;Bizkaia;025;Zeberio;1095;568;527
48;Bizkaia;913;Zierbena;1520;803;717
48;Bizkaia;915;Ziortza-Bolibar;404;215;189
09;Burgos;001;Abajas;31;20;11
09;Burgos;003;Adrada de Haza;203;99;104
09;Burgos;006;Aguas Cándidas;56;34;22
09;Burgos;007;Aguilar de Bureba;57;38;19
09;Burgos;009;Albillos;210;113;97
09;Burgos;010;Alcocero de Mola;32;23;9
09;Burgos;011;Alfoz de Bricia;70;43;27
09;Burgos;907;Alfoz de Quintanadueñas;2179;1149;1030
09;Burgos;012;Alfoz de Santa Gadea;104;60;44
09;Burgos;013;Altable;46;27;19
09;Burgos;014;Altos, Los;184;107;77
09;Burgos;016;Ameyugo;113;56;57
09;Burgos;017;Anguix;155;87;68
09;Burgos;018;Aranda de Duero;33187;16064;17123
09;Burgos;019;Arandilla;162;102;60
09;Burgos;020;Arauzo de Miel;306;171;135
09;Burgos;021;Arauzo de Salce;54;31;23
09;Burgos;022;Arauzo de Torre;77;46;31
09;Burgos;023;Arcos;1775;927;848
09;Burgos;024;Arenillas de Riopisuerga;174;102;72
09;Burgos;025;Arija;121;64;57
09;Burgos;026;Arlanzón;407;243;164
09;Burgos;027;Arraya de Oca;47;28;19
09;Burgos;029;Atapuerca;166;96;70
09;Burgos;030;Ausines, Los;133;81;52
09;Burgos;032;Avellanosa de Muñó;106;58;48
09;Burgos;033;Bahabón de Esgueva;79;43;36
09;Burgos;034;Balbases, Los;319;175;144
09;Burgos;035;Baños de Valdearados;333;195;138
09;Burgos;036;Bañuelos de Bureba;35;21;14
09;Burgos;037;Barbadillo de Herreros;109;69;40
09;Burgos;038;Barbadillo del Mercado;140;80;60
09;Burgos;039;Barbadillo del Pez;63;38;25
09;Burgos;041;Barrio de Muñó;31;17;14
09;Burgos;043;Barrios de Bureba, Los;179;106;73
09;Burgos;044;Barrios de Colina;55;30;25
09;Burgos;045;Basconcillos del Tozo;295;166;129
09;Burgos;046;Bascuñana;23;15;8
09;Burgos;047;Belbimbre;57;31;26
09;Burgos;048;Belorado;1780;913;867
09;Burgos;050;Berberana;60;35;25
09;Burgos;051;Berlangas de Roa;183;95;88
09;Burgos;052;Berzosa de Bureba;29;22;7
09;Burgos;054;Bozoó;97;60;37
09;Burgos;055;Brazacorta;54;31;23
09;Burgos;056;Briviesca;6582;3293;3289
09;Burgos;057;Bugedo;187;121;66
09;Burgos;058;Buniel;563;306;257
09;Burgos;059;Burgos;176418;83995;92423
09;Burgos;060;Busto de Bureba;133;71;62
09;Burgos;061;Cabañes de Esgueva;160;92;68
09;Burgos;062;Cabezón de la Sierra;40;17;23
09;Burgos;064;Caleruega;420;210;210
09;Burgos;065;Campillo de Aranda;179;101;78
09;Burgos;066;Campolara;57;41;16
09;Burgos;067;Canicosa de la Sierra;433;228;205
09;Burgos;068;Cantabrana;25;15;10
09;Burgos;070;Carazo;30;21;9
09;Burgos;071;Carcedo de Bureba;40;21;19
09;Burgos;072;Carcedo de Burgos;424;221;203
09;Burgos;073;Cardeñadijo;1369;756;613
09;Burgos;074;Cardeñajimeno;1136;593;543
09;Burgos;075;Cardeñuela Riopico;115;68;47
09;Burgos;076;Carrias;25;19;6
09;Burgos;077;Cascajares de Bureba;30;14;16
09;Burgos;078;Cascajares de la Sierra;33;18;15
09;Burgos;079;Castellanos de Castro;50;30;20
09;Burgos;083;Castil de Peones;25;13;12
09;Burgos;082;Castildelgado;36;21;15
09;Burgos;084;Castrillo de la Reina;176;119;57
09;Burgos;085;Castrillo de la Vega;650;351;299
09;Burgos;088;Castrillo de Riopisuerga;60;36;24
09;Burgos;086;Castrillo del Val;793;449;344
09;Burgos;090;Castrillo Mota de Judíos;50;27;23
09;Burgos;091;Castrojeriz;782;413;369
09;Burgos;063;Cavia;238;141;97
09;Burgos;093;Cayuela;183;100;83
09;Burgos;094;Cebrecos;52;34;18
09;Burgos;095;Celada del Camino;115;55;60
09;Burgos;098;Cerezo de Río Tirón;541;289;252
09;Burgos;100;Cerratón de Juarros;55;37;18
09;Burgos;101;Ciadoncha;80;52;28
09;Burgos;102;Cillaperlata;31;21;10
09;Burgos;103;Cilleruelo de Abajo;210;119;91
09;Burgos;104;Cilleruelo de Arriba;47;23;24
09;Burgos;105;Ciruelos de Cervera;97;56;41
09;Burgos;108;Cogollos;570;319;251
09;Burgos;109;Condado de Treviño;1363;753;610
09;Burgos;110;Contreras;80;52;28
09;Burgos;112;Coruña del Conde;107;67;40
09;Burgos;113;Covarrubias;541;288;253
09;Burgos;114;Cubillo del Campo;99;56;43
09;Burgos;115;Cubo de Bureba;95;54;41
09;Burgos;117;Cueva de Roa, La;120;61;59
09;Burgos;119;Cuevas de San Clemente;41;17;24
09;Burgos;120;Encío;44;22;22
09;Burgos;122;Espinosa de Cervera;91;58;33
09;Burgos;124;Espinosa de los Monteros;1651;850;801
09;Burgos;123;Espinosa del Camino;42;25;17
09;Burgos;125;Estépar;596;355;241
09;Burgos;127;Fontioso;57;34;23
09;Burgos;128;Frandovínez;86;50;36
09;Burgos;129;Fresneda de la Sierra Tirón;94;58;36
09;Burgos;130;Fresneña;68;45;23
09;Burgos;131;Fresnillo de las Dueñas;677;346;331
09;Burgos;132;Fresno de Río Tirón;184;112;72
09;Burgos;133;Fresno de Rodilla;44;26;18
09;Burgos;134;Frías;247;129;118
09;Burgos;135;Fuentebureba;47;27;20
09;Burgos;136;Fuentecén;217;121;96
09;Burgos;137;Fuentelcésped;252;130;122
09;Burgos;138;Fuentelisendo;92;51;41
09;Burgos;139;Fuentemolinos;100;68;32
09;Burgos;140;Fuentenebro;131;80;51
09;Burgos;141;Fuentespina;785;405;380
09;Burgos;143;Galbarros;30;18;12
09;Burgos;144;Gallega, La;45;29;16
09;Burgos;148;Grijalba;112;54;58
09;Burgos;149;Grisaleña;49;36;13
09;Burgos;151;Gumiel de Izán;561;313;248
09;Burgos;152;Gumiel de Mercado;359;195;164
09;Burgos;154;Hacinas;144;88;56
09;Burgos;155;Haza;30;19;11
09;Burgos;159;Hontanas;74;46;28
09;Burgos;160;Hontangas;87;59;28
09;Burgos;162;Hontoria de la Cantera;145;78;67
09;Burgos;164;Hontoria de Valdearados;175;105;70
09;Burgos;163;Hontoria del Pinar;650;363;287
09;Burgos;166;Hormazas, Las;96;53;43
09;Burgos;167;Hornillos del Camino;59;33;26
09;Burgos;168;Horra, La;335;187;148
09;Burgos;169;Hortigüela;105;70;35
09;Burgos;170;Hoyales de Roa;234;121;113
09;Burgos;172;Huérmeces;161;90;71
09;Burgos;173;Huerta de Arriba;125;71;54
09;Burgos;174;Huerta de Rey;901;489;412
09;Burgos;175;Humada;118;79;39
09;Burgos;176;Hurones;62;43;19
09;Burgos;177;Ibeas de Juarros;1405;754;651
09;Burgos;178;Ibrillos;39;26;13
09;Burgos;179;Iglesiarrubia;39;22;17
09;Burgos;180;Iglesias;143;79;64
09;Burgos;181;Isar;287;147;140
09;Burgos;182;Itero del Castillo;80;47;33
09;Burgos;183;Jaramillo de la Fuente;42;28;14
09;Burgos;184;Jaramillo Quemado;10;9;1
09;Burgos;189;Junta de Traslaloma;128;71;57
09;Burgos;190;Junta de Villalba de Losa;87;49;38
09;Burgos;191;Jurisdicción de Lara;31;19;12
09;Burgos;192;Jurisdicción de San Zadornil;57;32;25
09;Burgos;194;Lerma;2537;1275;1262
09;Burgos;195;Llano de Bureba;57;37;20
09;Burgos;196;Madrigal del Monte;147;89;58
09;Burgos;197;Madrigalejo del Monte;174;116;58
09;Burgos;198;Mahamud;100;54;46
09;Burgos;199;Mambrilla de Castrejón;104;65;39
09;Burgos;200;Mambrillas de Lara;45;28;17
09;Burgos;201;Mamolar;27;20;7
09;Burgos;202;Manciles;20;13;7
09;Burgos;206;Mazuela;55;32;23
09;Burgos;208;Mecerreyes;193;105;88
09;Burgos;209;Medina de Pomar;5734;2907;2827
09;Burgos;211;Melgar de Fernamental;1548;841;707
09;Burgos;213;Merindad de Cuesta-Urria;291;162;129
09;Burgos;214;Merindad de Montija;707;418;289
09;Burgos;906;Merindad de Río Ubierna;1418;794;624
09;Burgos;215;Merindad de Sotoscueva;396;225;171
09;Burgos;216;Merindad de Valdeporres;412;218;194
09;Burgos;217;Merindad de Valdivielso;380;223;157
09;Burgos;218;Milagros;434;235;199
09;Burgos;219;Miranda de Ebro;35760;17609;18151
09;Burgos;220;Miraveche;70;45;25
09;Burgos;221;Modúbar de la Emparedada;710;387;323
09;Burgos;223;Monasterio de la Sierra;43;27;16
09;Burgos;224;Monasterio de Rodilla;165;89;76
09;Burgos;225;Moncalvillo;81;48;33
09;Burgos;226;Monterrubio de la Demanda;56;34;22
09;Burgos;227;Montorio;142;78;64
09;Burgos;228;Moradillo de Roa;171;94;77
09;Burgos;229;Nava de Roa;220;115;105
09;Burgos;230;Navas de Bureba;33;16;17
09;Burgos;231;Nebreda;57;42;15
09;Burgos;232;Neila;153;87;66
09;Burgos;235;Olmedillo de Roa;191;110;81
09;Burgos;236;Olmillos de Muñó;37;20;17
09;Burgos;238;Oña;1003;526;477
09;Burgos;239;Oquillas;54;31;23
09;Burgos;241;Orbaneja Riopico;339;189;150
09;Burgos;242;Padilla de Abajo;80;48;32
09;Burgos;243;Padilla de Arriba;79;49;30
09;Burgos;244;Padrones de Bureba;46;21;25
09;Burgos;246;Palacios de la Sierra;701;357;344
09;Burgos;247;Palacios de Riopisuerga;24;12;12
09;Burgos;248;Palazuelos de la Sierra;85;50;35
09;Burgos;249;Palazuelos de Muñó;50;28;22
09;Burgos;250;Pampliega;298;161;137
09;Burgos;251;Pancorbo;429;229;200
09;Burgos;253;Pardilla;118;71;47
09;Burgos;255;Partido de la Sierra en Tobalina;83;50;33
09;Burgos;256;Pedrosa de Duero;500;285;215
09;Burgos;259;Pedrosa de Río Úrbel;248;147;101
09;Burgos;257;Pedrosa del Páramo;89;53;36
09;Burgos;258;Pedrosa del Príncipe;169;91;78
09;Burgos;261;Peñaranda de Duero;516;259;257
09;Burgos;262;Peral de Arlanza;172;96;76
09;Burgos;265;Piérnigas;48;31;17
09;Burgos;266;Pineda de la Sierra;98;63;35
09;Burgos;267;Pineda Trasmonte;121;70;51
09;Burgos;268;Pinilla de los Barruecos;92;54;38
09;Burgos;269;Pinilla de los Moros;37;19;18
09;Burgos;270;Pinilla Trasmonte;168;95;73
09;Burgos;272;Poza de la Sal;274;148;126
09;Burgos;273;Prádanos de Bureba;52;33;19
09;Burgos;274;Pradoluengo;1151;576;575
09;Burgos;275;Presencio;184;110;74
09;Burgos;276;Puebla de Arganzón, La;502;274;228
09;Burgos;277;Puentedura;109;75;34
09;Burgos;279;Quemada;250;150;100
09;Burgos;281;Quintana del Pidio;156;82;74
09;Burgos;280;Quintanabureba;23;13;10
09;Burgos;283;Quintanaélez;44;22;22
09;Burgos;287;Quintanaortuño;261;146;115
09;Burgos;288;Quintanapalla;110;59;51
09;Burgos;289;Quintanar de la Sierra;1603;849;754
09;Burgos;292;Quintanavides;74;44;30
09;Burgos;294;Quintanilla de la Mata;110;65;45
09;Burgos;901;Quintanilla del Agua y Tordueles;360;192;168
09;Burgos;295;Quintanilla del Coco;54;28;26
09;Burgos;298;Quintanilla San García;79;48;31
09;Burgos;301;Quintanilla Vivar;820;437;383
09;Burgos;297;Quintanillas, Las;362;214;148
09;Burgos;302;Rabanera del Pinar;102;63;39
09;Burgos;303;Rábanos;80;48;32
09;Burgos;304;Rabé de las Calzadas;229;114;115
09;Burgos;306;Rebolledo de la Torre;106;60;46
09;Burgos;307;Redecilla del Camino;103;68;35
09;Burgos;308;Redecilla del Campo;66;36;30
09;Burgos;309;Regumiel de la Sierra;334;176;158
09;Burgos;310;Reinoso;15;10;5
09;Burgos;311;Retuerta;62;38;24
09;Burgos;314;Revilla del Campo;100;62;38
09;Burgos;316;Revilla Vallejera;104;63;41
09;Burgos;312;Revilla y Ahedo, La;100;57;43
09;Burgos;315;Revillarruz;523;270;253
09;Burgos;317;Rezmondo;21;8;13
09;Burgos;318;Riocavado de la Sierra;55;36;19
09;Burgos;321;Roa;2167;1091;1076
09;Burgos;323;Rojas;63;45;18
09;Burgos;325;Royuela de Río Franco;174;104;70
09;Burgos;326;Rubena;191;114;77
09;Burgos;327;Rublacedo de Abajo;30;16;14
09;Burgos;328;Rucandio;69;34;35
09;Burgos;329;Salas de Bureba;131;74;57
09;Burgos;330;Salas de los Infantes;1987;1022;965
09;Burgos;332;Saldaña de Burgos;180;102;78
09;Burgos;334;Salinillas de Bureba;54;41;13
09;Burgos;335;San Adrián de Juarros;85;55;30
09;Burgos;337;San Juan del Monte;149;82;67
09;Burgos;338;San Mamés de Burgos;287;163;124
09;Burgos;339;San Martín de Rubiales;150;90;60
09;Burgos;340;San Millán de Lara;72;50;22
09;Burgos;360;San Vicente del Valle;27;21;6
09;Burgos;343;Santa Cecilia;98;61;37
09;Burgos;345;Santa Cruz de la Salceda;140;86;54
09;Burgos;346;Santa Cruz del Valle Urbión;99;66;33
09;Burgos;347;Santa Gadea del Cid;153;78;75
09;Burgos;348;Santa Inés;139;78;61
09;Burgos;350;Santa María del Campo;517;281;236
09;Burgos;351;Santa María del Invierno;63;45;18
09;Burgos;352;Santa María del Mercadillo;101;67;34
09;Burgos;353;Santa María Rivarredonda;92;56;36
09;Burgos;354;Santa Olalla de Bureba;37;26;11
09;Burgos;355;Santibáñez de Esgueva;79;45;34
09;Burgos;356;Santibáñez del Val;47;29;18
09;Burgos;358;Santo Domingo de Silos;273;168;105
09;Burgos;361;Sargentes de la Lora;111;63;48
09;Burgos;362;Sarracín;248;131;117
09;Burgos;363;Sasamón;962;552;410
09;Burgos;365;Sequera de Haza, La;27;19;8
09;Burgos;366;Solarana;77;43;34
09;Burgos;368;Sordillos;33;20;13
09;Burgos;369;Sotillo de la Ribera;475;249;226
09;Burgos;372;Sotragero;273;149;124
09;Burgos;373;Sotresgudo;432;249;183
09;Burgos;374;Susinos del Páramo;116;73;43
09;Burgos;375;Tamarón;44;24;20
09;Burgos;377;Tardajos;783;416;367
09;Burgos;378;Tejada;34;19;15
09;Burgos;380;Terradillos de Esgueva;77;38;39
09;Burgos;381;Tinieblas de la Sierra;34;19;15
09;Burgos;382;Tobar;22;17;5
09;Burgos;384;Tordómar;334;183;151
09;Burgos;386;Torrecilla del Monte;72;39;33
09;Burgos;387;Torregalindo;121;74;47
09;Burgos;388;Torrelara;31;18;13
09;Burgos;389;Torrepadre;70;41;29
09;Burgos;390;Torresandino;604;322;282
09;Burgos;391;Tórtoles de Esgueva;433;229;204
09;Burgos;392;Tosantos;52;28;24
09;Burgos;394;Trespaderne;771;386;385
09;Burgos;395;Tubilla del Agua;136;82;54
09;Burgos;396;Tubilla del Lago;169;93;76
09;Burgos;398;Úrbel del Castillo;72;47;25
09;Burgos;400;Vadocondes;345;192;153
09;Burgos;403;Valdeande;104;61;43
09;Burgos;405;Valdezate;134;77;57
09;Burgos;406;Valdorros;297;175;122
09;Burgos;408;Vallarta de Bureba;40;27;13
09;Burgos;904;Valle de las Navas;509;303;206
09;Burgos;908;Valle de Losa;481;276;205
09;Burgos;409;Valle de Manzanedo;122;65;57
09;Burgos;410;Valle de Mena;3805;1941;1864
09;Burgos;411;Valle de Oca;165;98;67
09;Burgos;902;Valle de Santibáñez;483;276;207
09;Burgos;905;Valle de Sedano;421;239;182
09;Burgos;412;Valle de Tobalina;909;499;410
09;Burgos;413;Valle de Valdebezana;456;238;218
09;Burgos;414;Valle de Valdelaguna;186;111;75
09;Burgos;415;Valle de Valdelucio;330;182;148
09;Burgos;416;Valle de Zamanzas;53;31;22
09;Burgos;417;Vallejera;42;24;18
09;Burgos;418;Valles de Palenzuela;79;39;40
09;Burgos;419;Valluércanes;71;47;24
09;Burgos;407;Valmala;25;12;13
09;Burgos;422;Vid de Bureba, La;31;18;13
09;Burgos;421;Vid y Barrios, La;250;147;103
09;Burgos;423;Vileña;27;17;10
09;Burgos;427;Villadiego;1500;831;669
09;Burgos;428;Villaescusa de Roa;100;57;43
09;Burgos;429;Villaescusa la Sombría;58;43;15
09;Burgos;430;Villaespasa;27;16;11
09;Burgos;431;Villafranca Montes de Oca;113;69;44
09;Burgos;432;Villafruela;176;103;73
09;Burgos;433;Villagalijo;61;38;23
09;Burgos;434;Villagonzalo Pedernales;1859;978;881
09;Burgos;437;Villahoz;287;152;135
09;Burgos;438;Villalba de Duero;705;374;331
09;Burgos;439;Villalbilla de Burgos;1423;772;651
09;Burgos;440;Villalbilla de Gumiel;85;55;30
09;Burgos;441;Villaldemiro;97;54;43
09;Burgos;442;Villalmanzo;420;230;190
09;Burgos;443;Villamayor de los Montes;165;77;88
09;Burgos;444;Villamayor de Treviño;61;32;29
09;Burgos;445;Villambistia;44;32;12
09;Burgos;446;Villamedianilla;11;8;3
09;Burgos;447;Villamiel de la Sierra;44;27;17
09;Burgos;448;Villangómez;217;131;86
09;Burgos;449;Villanueva de Argaño;114;64;50
09;Burgos;450;Villanueva de Carazo;26;16;10
09;Burgos;451;Villanueva de Gumiel;273;143;130
09;Burgos;454;Villanueva de Teba;41;27;14
09;Burgos;455;Villaquirán de la Puebla;46;27;19
09;Burgos;456;Villaquirán de los Infantes;160;83;77
09;Burgos;903;Villarcayo de Merindad de Castilla la Vieja;4011;2065;1946
09;Burgos;458;Villariezo;645;358;287
09;Burgos;460;Villasandino;180;101;79
09;Burgos;463;Villasur de Herreros;264;164;100
09;Burgos;464;Villatuelda;37;20;17
09;Burgos;466;Villaverde del Monte;112;67;45
09;Burgos;467;Villaverde-Mogina;74;51;23
09;Burgos;471;Villayerno Morquillas;195;105;90
09;Burgos;472;Villazopeque;53;31;22
09;Burgos;473;Villegas;89;51;38
09;Burgos;476;Villoruebo;72;47;25
09;Burgos;424;Viloria de Rioja;39;23;16
09;Burgos;425;Vilviestre del Pinar;516;283;233
09;Burgos;478;Vizcaínos;44;32;12
09;Burgos;480;Zael;112;59;53
09;Burgos;482;Zarzosa de Río Pisuerga;34;21;13
09;Burgos;483;Zazuar;210;106;104
09;Burgos;485;Zuñeda;53;31;22
10;Cáceres;001;Abadía;336;183;153
10;Cáceres;002;Abertura;404;200;204
10;Cáceres;003;Acebo;557;274;283
10;Cáceres;004;Acehúche;802;408;394
10;Cáceres;005;Aceituna;600;306;294
10;Cáceres;006;Ahigal;1381;711;670
10;Cáceres;903;Alagón del Río;932;463;469
10;Cáceres;007;Albalá;669;351;318
10;Cáceres;008;Alcántara;1411;701;710
10;Cáceres;009;Alcollarín;282;144;138
10;Cáceres;010;Alcuéscar;2554;1329;1225
10;Cáceres;012;Aldea del Cano;602;284;318
10;Cáceres;013;Aldea del Obispo, La;298;161;137
10;Cáceres;011;Aldeacentenera;561;288;273
10;Cáceres;014;Aldeanueva de la Vera;2042;1003;1039
10;Cáceres;015;Aldeanueva del Camino;727;355;372
10;Cáceres;016;Aldehuela de Jerte;371;197;174
10;Cáceres;017;Alía;816;420;396
10;Cáceres;018;Aliseda;1777;900;877
10;Cáceres;019;Almaraz;1726;881;845
10;Cáceres;020;Almoharín;1811;884;927
10;Cáceres;021;Arroyo de la Luz;5766;2857;2909
10;Cáceres;023;Arroyomolinos;828;422;406
10;Cáceres;022;Arroyomolinos de la Vera;441;218;223
10;Cáceres;024;Baños de Montemayor;751;353;398
10;Cáceres;025;Barrado;387;200;187
10;Cáceres;026;Belvís de Monroy;733;381;352
10;Cáceres;027;Benquerencia;80;48;32
10;Cáceres;028;Berrocalejo;97;54;43
10;Cáceres;029;Berzocana;414;222;192
10;Cáceres;030;Bohonal de Ibor;481;246;235
10;Cáceres;031;Botija;171;88;83
10;Cáceres;032;Brozas;1804;903;901
10;Cáceres;033;Cabañas del Castillo;424;220;204
10;Cáceres;034;Cabezabellosa;340;172;168
10;Cáceres;035;Cabezuela del Valle;2129;1091;1038
10;Cáceres;036;Cabrero;328;182;146
10;Cáceres;037;Cáceres;96255;46104;50151
10;Cáceres;038;Cachorrilla;87;44;43
10;Cáceres;039;Cadalso;426;218;208
10;Cáceres;040;Calzadilla;463;235;228
10;Cáceres;041;Caminomorisco;1181;620;561
10;Cáceres;042;Campillo de Deleitosa;75;33;42
10;Cáceres;043;Campo Lugar;814;407;407
10;Cáceres;044;Cañamero;1618;843;775
10;Cáceres;045;Cañaveral;1036;508;528
10;Cáceres;046;Carbajo;197;102;95
10;Cáceres;047;Carcaboso;1085;549;536
10;Cáceres;048;Carrascalejo;220;111;109
10;Cáceres;049;Casar de Cáceres;4499;2223;2276
10;Cáceres;050;Casar de Palomero;1084;553;531
10;Cáceres;051;Casares de las Hurdes;400;202;198
10;Cáceres;052;Casas de Don Antonio;170;85;85
10;Cáceres;053;Casas de Don Gómez;283;152;131
10;Cáceres;056;Casas de Millán;550;280;270
10;Cáceres;057;Casas de Miravete;126;79;47
10;Cáceres;054;Casas del Castañar;552;269;283
10;Cáceres;055;Casas del Monte;811;420;391
10;Cáceres;058;Casatejada;1344;706;638
10;Cáceres;059;Casillas de Coria;345;170;175
10;Cáceres;060;Castañar de Ibor;1033;533;500
10;Cáceres;061;Ceclavín;1812;914;898
10;Cáceres;062;Cedillo;428;222;206
10;Cáceres;063;Cerezo;159;81;78
10;Cáceres;064;Cilleros;1602;810;792
10;Cáceres;065;Collado de la Vera;191;106;85
10;Cáceres;066;Conquista de la Sierra;185;107;78
10;Cáceres;067;Coria;12366;6066;6300
10;Cáceres;068;Cuacos de Yuste;851;436;415
10;Cáceres;069;Cumbre, La;841;432;409
10;Cáceres;070;Deleitosa;687;349;338
10;Cáceres;071;Descargamaría;116;65;51
10;Cáceres;072;Eljas;901;467;434
10;Cáceres;073;Escurial;865;452;413
10;Cáceres;075;Fresnedoso de Ibor;262;140;122
10;Cáceres;076;Galisteo;916;460;456
10;Cáceres;077;Garciaz;699;362;337
10;Cáceres;079;Garganta la Olla;926;490;436
10;Cáceres;078;Garganta, La;365;199;166
10;Cáceres;080;Gargantilla;376;194;182
10;Cáceres;081;Gargüera;164;89;75
10;Cáceres;082;Garrovillas de Alconétar;2004;992;1012
10;Cáceres;083;Garvín;104;55;49
10;Cáceres;084;Gata;1417;729;688
10;Cáceres;085;Gordo, El;360;188;172
10;Cáceres;086;Granja, La;323;163;160
10;Cáceres;087;Guadalupe;1828;918;910
10;Cáceres;088;Guijo de Coria;196;106;90
10;Cáceres;089;Guijo de Galisteo;1507;760;747
10;Cáceres;090;Guijo de Granadilla;522;274;248
10;Cáceres;091;Guijo de Santa Bárbara;378;197;181
10;Cáceres;092;Herguijuela;274;147;127
10;Cáceres;093;Hernán-Pérez;424;208;216
10;Cáceres;094;Herrera de Alcántara;240;121;119
10;Cáceres;095;Herreruela;330;166;164
10;Cáceres;096;Hervás;3957;1936;2021
10;Cáceres;097;Higuera;110;66;44
10;Cáceres;098;Hinojal;404;207;197
10;Cáceres;099;Holguera;637;323;314
10;Cáceres;100;Hoyos;880;436;444
10;Cáceres;101;Huélaga;219;109;110
10;Cáceres;102;Ibahernando;538;263;275
10;Cáceres;103;Jaraicejo;456;224;232
10;Cáceres;104;Jaraíz de la Vera;6503;3252;3251
10;Cáceres;105;Jarandilla de la Vera;2805;1402;1403
10;Cáceres;106;Jarilla;138;68;70
10;Cáceres;107;Jerte;1260;624;636
10;Cáceres;108;Ladrillar;192;110;82
10;Cáceres;109;Logrosán;1971;1003;968
10;Cáceres;110;Losar de la Vera;2717;1391;1326
10;Cáceres;111;Madrigal de la Vera;1561;812;749
10;Cáceres;112;Madrigalejo;1712;865;847
10;Cáceres;113;Madroñera;2496;1248;1248
10;Cáceres;114;Majadas;1322;668;654
10;Cáceres;115;Malpartida de Cáceres;4076;2042;2034
10;Cáceres;116;Malpartida de Plasencia;4602;2287;2315
10;Cáceres;117;Marchagaz;203;104;99
10;Cáceres;118;Mata de Alcántara;301;154;147
10;Cáceres;119;Membrío;605;300;305
10;Cáceres;120;Mesas de Ibor;163;83;80
10;Cáceres;121;Miajadas;9527;4759;4768
10;Cáceres;122;Millanes;255;131;124
10;Cáceres;123;Mirabel;661;326;335
10;Cáceres;124;Mohedas de Granadilla;838;421;417
10;Cáceres;125;Monroy;938;480;458
10;Cáceres;126;Montánchez;1668;840;828
10;Cáceres;127;Montehermoso;5718;2905;2813
10;Cáceres;128;Moraleja;6696;3315;3381
10;Cáceres;129;Morcillo;358;167;191
10;Cáceres;130;Navaconcejo;2024;1019;1005
10;Cáceres;131;Navalmoral de la Mata;17163;8306;8857
10;Cáceres;132;Navalvillar de Ibor;388;195;193
10;Cáceres;133;Navas del Madroño;1280;637;643
10;Cáceres;134;Navezuelas;632;325;307
10;Cáceres;135;Nuñomoral;1252;666;586
10;Cáceres;136;Oliva de Plasencia;296;167;129
10;Cáceres;137;Palomero;396;208;188
10;Cáceres;138;Pasarón de la Vera;604;293;311
10;Cáceres;139;Pedroso de Acim;80;43;37
10;Cáceres;140;Peraleda de la Mata;1393;700;693
10;Cáceres;141;Peraleda de San Román;300;162;138
10;Cáceres;142;Perales del Puerto;938;474;464
10;Cáceres;143;Pescueza;146;65;81
10;Cáceres;144;Pesga, La;1018;532;486
10;Cáceres;145;Piedras Albas;141;69;72
10;Cáceres;146;Pinofranqueado;1692;899;793
10;Cáceres;147;Piornal;1483;752;731
10;Cáceres;148;Plasencia;39860;19170;20690
10;Cáceres;149;Plasenzuela;487;246;241
10;Cáceres;150;Portaje;370;190;180
10;Cáceres;151;Portezuelo;211;113;98
10;Cáceres;152;Pozuelo de Zarzón;454;231;223
10;Cáceres;905;Pueblonuevo de Miramontes;782;394;388
10;Cáceres;153;Puerto de Santa Cruz;304;161;143
10;Cáceres;154;Rebollar;215;106;109
10;Cáceres;155;Riolobos;1201;613;588
10;Cáceres;156;Robledillo de Gata;90;50;40
10;Cáceres;157;Robledillo de la Vera;258;130;128
10;Cáceres;158;Robledillo de Trujillo;360;179;181
10;Cáceres;159;Robledollano;294;157;137
10;Cáceres;160;Romangordo;263;130;133
10;Cáceres;901;Rosalejo;1334;686;648
10;Cáceres;161;Ruanes;80;43;37
10;Cáceres;162;Salorino;560;293;267
10;Cáceres;163;Salvatierra de Santiago;298;151;147
10;Cáceres;164;San Martín de Trevejo;766;381;385
10;Cáceres;165;Santa Ana;256;136;120
10;Cáceres;166;Santa Cruz de la Sierra;326;166;160
10;Cáceres;167;Santa Cruz de Paniagua;316;173;143
10;Cáceres;168;Santa Marta de Magasca;299;149;150
10;Cáceres;169;Santiago de Alcántara;507;247;260
10;Cáceres;170;Santiago del Campo;237;122;115
10;Cáceres;171;Santibáñez el Alto;361;196;165
10;Cáceres;172;Santibáñez el Bajo;741;378;363
10;Cáceres;173;Saucedilla;852;434;418
10;Cáceres;174;Segura de Toro;181;89;92
10;Cáceres;175;Serradilla;1507;755;752
10;Cáceres;176;Serrejón;410;213;197
10;Cáceres;177;Sierra de Fuentes;1998;1018;980
10;Cáceres;178;Talaván;806;421;385
10;Cáceres;179;Talaveruela de la Vera;298;159;139
10;Cáceres;180;Talayuela;7395;3952;3443
10;Cáceres;181;Tejeda de Tiétar;773;410;363
10;Cáceres;904;Tiétar;879;472;407
10;Cáceres;182;Toril;153;99;54
10;Cáceres;183;Tornavacas;1098;585;513
10;Cáceres;184;Torno, El;851;451;400
10;Cáceres;187;Torre de Don Miguel;484;257;227
10;Cáceres;188;Torre de Santa María;532;268;264
10;Cáceres;185;Torrecilla de los Ángeles;601;326;275
10;Cáceres;186;Torrecillas de la Tiesa;1070;541;529
10;Cáceres;190;Torrejón el Rubio;546;276;270
10;Cáceres;189;Torrejoncillo;2910;1410;1500
10;Cáceres;191;Torremenga;587;313;274
10;Cáceres;192;Torremocha;793;395;398
10;Cáceres;193;Torreorgaz;1656;813;843
10;Cáceres;194;Torrequemada;560;275;285
10;Cáceres;195;Trujillo;8912;4335;4577
10;Cáceres;196;Valdastillas;321;165;156
10;Cáceres;197;Valdecañas de Tajo;106;53;53
10;Cáceres;198;Valdefuentes;1139;562;577
10;Cáceres;199;Valdehúncar;171;92;79
10;Cáceres;200;Valdelacasa de Tajo;348;183;165
10;Cáceres;201;Valdemorales;202;100;102
10;Cáceres;202;Valdeobispo;644;318;326
10;Cáceres;203;Valencia de Alcántara;5373;2627;2746
10;Cáceres;204;Valverde de la Vera;465;238;227
10;Cáceres;205;Valverde del Fresno;2250;1141;1109
10;Cáceres;902;Vegaviana;868;448;420
10;Cáceres;206;Viandar de la Vera;219;114;105
10;Cáceres;207;Villa del Campo;478;225;253
10;Cáceres;208;Villa del Rey;133;66;67
10;Cáceres;209;Villamesías;259;133;126
10;Cáceres;210;Villamiel;400;204;196
10;Cáceres;211;Villanueva de la Sierra;441;222;219
10;Cáceres;212;Villanueva de la Vera;2062;1026;1036
10;Cáceres;214;Villar de Plasencia;233;122;111
10;Cáceres;213;Villar del Pedroso;582;299;283
10;Cáceres;215;Villasbuenas de Gata;376;183;193
10;Cáceres;216;Zarza de Granadilla;1800;911;889
10;Cáceres;217;Zarza de Montánchez;548;277;271
10;Cáceres;218;Zarza la Mayor;1199;595;604
10;Cáceres;219;Zorita;1332;678;654
11;Cádiz;001;Alcalá de los Gazules;5226;2691;2535
11;Cádiz;002;Alcalá del Valle;5043;2533;2510
11;Cádiz;003;Algar;1428;726;702
11;Cádiz;004;Algeciras;123078;60729;62349
11;Cádiz;005;Algodonales;5506;2781;2725
11;Cádiz;006;Arcos de la Frontera;30818;15390;15428
11;Cádiz;007;Barbate;22556;11306;11250
11;Cádiz;008;Barrios, Los;23777;11924;11853
11;Cádiz;901;Benalup-Casas Viejas;6986;3538;3448
11;Cádiz;009;Benaocaz;673;361;312
11;Cádiz;010;Bornos;7654;3815;3839
11;Cádiz;011;Bosque, El;2137;1079;1058
11;Cádiz;012;Cádiz;115439;54580;60859
11;Cádiz;013;Castellar de la Frontera;3057;1527;1530
11;Cádiz;015;Chiclana de la Frontera;85150;42607;42543
11;Cádiz;016;Chipiona;19246;9629;9617
11;Cádiz;014;Conil de la Frontera;22775;11470;11305
11;Cádiz;017;Espera;3869;1950;1919
11;Cádiz;018;Gastor, El;1729;887;842
11;Cádiz;019;Grazalema;2013;997;1016
11;Cádiz;020;Jerez de la Frontera;213105;104086;109019
11;Cádiz;021;Jimena de la Frontera;6707;3413;3294
11;Cádiz;022;Línea de la Concepción, La;63630;31207;32423
11;Cádiz;023;Medina Sidonia;11773;5974;5799
11;Cádiz;024;Olvera;8062;3949;4113
11;Cádiz;025;Paterna de Rivera;5453;2824;2629
11;Cádiz;026;Prado del Rey;5590;2787;2803
11;Cádiz;027;Puerto de Santa María, El;88703;43437;45266
11;Cádiz;028;Puerto Real;41700;20942;20758
11;Cádiz;029;Puerto Serrano;6942;3511;3431
11;Cádiz;030;Rota;29282;14557;14725
11;Cádiz;031;San Fernando;95001;46420;48581
11;Cádiz;902;San José del Valle;4433;2274;2159
11;Cádiz;903;San Martín del Tesorillo;2801;1446;1355
11;Cádiz;033;San Roque;31571;15782;15789
11;Cádiz;032;Sanlúcar de Barrameda;69205;34479;34726
11;Cádiz;034;Setenil de las Bodegas;2741;1408;1333
11;Cádiz;035;Tarifa;18183;9140;9043
11;Cádiz;036;Torre Alháquime;796;400;396
11;Cádiz;037;Trebujena;7016;3488;3528
11;Cádiz;038;Ubrique;16605;8205;8400
11;Cádiz;039;Vejer de la Frontera;12622;6275;6347
11;Cádiz;040;Villaluenga del Rosario;455;238;217
11;Cádiz;041;Villamartín;12134;6098;6036
11;Cádiz;042;Zahara;1379;701;678
39;Cantabria;001;Alfoz de Lloredo;2394;1238;1156
39;Cantabria;002;Ampuero;4319;2166;2153
39;Cantabria;003;Anievas;274;148;126
39;Cantabria;004;Arenas de Iguña;1665;848;817
39;Cantabria;005;Argoños;1788;925;863
39;Cantabria;006;Arnuero;2106;1048;1058
39;Cantabria;007;Arredondo;452;252;200
39;Cantabria;008;Astillero, El;18134;8862;9272
39;Cantabria;009;Bárcena de Cicero;4319;2212;2107
39;Cantabria;010;Bárcena de Pie de Concha;672;339;333
39;Cantabria;011;Bareyo;1994;993;1001
39;Cantabria;012;Cabezón de la Sal;8358;4007;4351
39;Cantabria;013;Cabezón de Liébana;604;338;266
39;Cantabria;014;Cabuérniga;965;520;445
39;Cantabria;015;Camaleño;930;525;405
39;Cantabria;016;Camargo;30320;14818;15502
39;Cantabria;027;Campoo de Enmedio;3696;1872;1824
39;Cantabria;017;Campoo de Yuso;670;363;307
39;Cantabria;018;Cartes;5731;2873;2858
39;Cantabria;019;Castañeda;2968;1509;1459
39;Cantabria;020;Castro-Urdiales;32270;15955;16315
39;Cantabria;021;Cieza;534;273;261
39;Cantabria;022;Cillorigo de Liébana;1299;677;622
39;Cantabria;023;Colindres;8598;4262;4336
39;Cantabria;024;Comillas;2124;999;1125
39;Cantabria;025;Corrales de Buelna, Los;10767;5258;5509
39;Cantabria;026;Corvera de Toranzo;2042;1031;1011
39;Cantabria;028;Entrambasaguas;5260;2630;2630
39;Cantabria;029;Escalante;781;404;377
39;Cantabria;030;Guriezo;2330;1209;1121
39;Cantabria;031;Hazas de Cesto;1580;780;800
39;Cantabria;032;Hermandad de Campoo de Suso;1588;884;704
39;Cantabria;033;Herrerías;587;329;258
39;Cantabria;034;Lamasón;269;169;100
39;Cantabria;035;Laredo;11023;5212;5811
39;Cantabria;036;Liendo;1196;619;577
39;Cantabria;037;Liérganes;2407;1190;1217
39;Cantabria;038;Limpias;1928;958;970
39;Cantabria;039;Luena;600;326;274
39;Cantabria;040;Marina de Cudeyo;5106;2556;2550
39;Cantabria;041;Mazcuerras;2093;1071;1022
39;Cantabria;042;Medio Cudeyo;7577;3680;3897
39;Cantabria;043;Meruelo;2086;1039;1047
39;Cantabria;044;Miengo;4891;2490;2401
39;Cantabria;045;Miera;381;200;181
39;Cantabria;046;Molledo;1507;748;759
39;Cantabria;047;Noja;2588;1292;1296
39;Cantabria;048;Penagos;2142;1087;1055
39;Cantabria;049;Peñarrubia;319;172;147
39;Cantabria;050;Pesaguero;295;169;126
39;Cantabria;051;Pesquera;79;46;33
39;Cantabria;052;Piélagos;25731;12708;13023
39;Cantabria;053;Polaciones;221;140;81
39;Cantabria;054;Polanco;5942;2942;3000
39;Cantabria;055;Potes;1332;648;684
39;Cantabria;056;Puente Viesgo;2845;1435;1410
39;Cantabria;057;Ramales de la Victoria;2877;1444;1433
39;Cantabria;058;Rasines;955;489;466
39;Cantabria;059;Reinosa;8946;4228;4718
39;Cantabria;060;Reocín;8399;4151;4248
39;Cantabria;061;Ribamontán al Mar;4478;2284;2194
39;Cantabria;062;Ribamontán al Monte;2303;1189;1114
39;Cantabria;063;Rionansa;1029;567;462
39;Cantabria;064;Riotuerto;1611;778;833
39;Cantabria;065;Rozas de Valdearroyo, Las;247;137;110
39;Cantabria;066;Ruente;1011;543;468
39;Cantabria;067;Ruesga;836;459;377
39;Cantabria;068;Ruiloba;722;368;354
39;Cantabria;069;San Felices de Buelna;2367;1198;1169
39;Cantabria;070;San Miguel de Aguayo;145;74;71
39;Cantabria;071;San Pedro del Romeral;474;263;211
39;Cantabria;072;San Roque de Riomiera;345;202;143
39;Cantabria;080;San Vicente de la Barquera;4095;2007;2088
39;Cantabria;073;Santa Cruz de Bezana;13088;6439;6649
39;Cantabria;074;Santa María de Cayón;9167;4561;4606
39;Cantabria;075;Santander;173375;79936;93439
39;Cantabria;076;Santillana del Mar;4229;2056;2173
39;Cantabria;077;Santiurde de Reinosa;255;148;107
39;Cantabria;078;Santiurde de Toranzo;1646;865;781
39;Cantabria;079;Santoña;11019;5345;5674
39;Cantabria;081;Saro;516;269;247
39;Cantabria;082;Selaya;1873;942;931
39;Cantabria;083;Soba;1155;641;514
39;Cantabria;084;Solórzano;1046;558;488
39;Cantabria;085;Suances;8827;4331;4496
39;Cantabria;086;Tojos, Los;387;230;157
39;Cantabria;087;Torrelavega;51597;24365;27232
39;Cantabria;088;Tresviso;59;42;17
39;Cantabria;089;Tudanca;135;97;38
39;Cantabria;090;Udías;928;471;457
39;Cantabria;095;Val de San Vicente;2758;1414;1344
39;Cantabria;091;Valdáliga;2150;1124;1026
39;Cantabria;092;Valdeolea;939;500;439
39;Cantabria;093;Valdeprado del Río;325;179;146
39;Cantabria;094;Valderredible;950;543;407
39;Cantabria;101;Valle de Villaverde;274;155;119
39;Cantabria;096;Vega de Liébana;719;380;339
39;Cantabria;097;Vega de Pas;746;401;345
39;Cantabria;098;Villacarriedo;1612;844;768
39;Cantabria;099;Villaescusa;3933;1926;2007
39;Cantabria;100;Villafufre;994;523;471
39;Cantabria;102;Voto;2686;1449;1237
12;Castellón/Castelló;002;Aín;123;64;59
12;Castellón/Castelló;003;Albocàsser;1227;618;609
12;Castellón/Castelló;004;Alcalà de Xivert;6638;3407;3231
12;Castellón/Castelló;005;Alcora, l';10417;5266;5151
12;Castellón/Castelló;006;Alcudia de Veo;188;102;86
12;Castellón/Castelló;007;Alfondeguilla;862;435;427
12;Castellón/Castelló;008;Algimia de Almonacid;262;146;116
12;Castellón/Castelló;009;Almassora;26742;13459;13283
12;Castellón/Castelló;010;Almedíjar;244;136;108
12;Castellón/Castelló;011;Almenara;6090;3064;3026
12;Castellón/Castelló;901;Alqueries, les/Alquerías del Niño Perdido;4464;2230;2234
12;Castellón/Castelló;012;Altura;3601;1863;1738
12;Castellón/Castelló;013;Arañuel;151;80;71
12;Castellón/Castelló;014;Ares del Maestrat;184;107;77
12;Castellón/Castelló;015;Argelita;126;74;52
12;Castellón/Castelló;016;Artana;1955;986;969
12;Castellón/Castelló;001;Atzeneta del Maestrat;1304;653;651
12;Castellón/Castelló;017;Ayódar;153;82;71
12;Castellón/Castelló;018;Azuébar;310;164;146
12;Castellón/Castelló;020;Barracas;168;100;68
12;Castellón/Castelló;022;Bejís;371;210;161
12;Castellón/Castelló;024;Benafer;164;87;77
12;Castellón/Castelló;025;Benafigos;138;82;56
12;Castellón/Castelló;026;Benassal;1063;543;520
12;Castellón/Castelló;027;Benicarló;27363;13635;13728
12;Castellón/Castelló;028;Benicasim/Benicàssim;18364;9113;9251
12;Castellón/Castelló;029;Benlloc;1048;525;523
12;Castellón/Castelló;021;Betxí;5618;2778;2840
12;Castellón/Castelló;032;Borriana/Burriana;35052;17420;17632
12;Castellón/Castelló;031;Borriol;5397;2756;2641
12;Castellón/Castelló;033;Cabanes;2978;1507;1471
12;Castellón/Castelló;034;Càlig;1961;998;963
12;Castellón/Castelló;036;Canet lo Roig;676;337;339
12;Castellón/Castelló;037;Castell de Cabres;22;13;9
12;Castellón/Castelló;038;Castellfort;179;96;83
12;Castellón/Castelló;039;Castellnovo;918;465;453
12;Castellón/Castelló;040;Castelló de la Plana;174264;84319;89945
12;Castellón/Castelló;041;Castillo de Villamalefa;101;68;33
12;Castellón/Castelló;042;Catí;714;359;355
12;Castellón/Castelló;043;Caudiel;659;341;318
12;Castellón/Castelló;044;Cervera del Maestre;557;268;289
12;Castellón/Castelló;053;Chilches/Xilxes;2714;1407;1307
12;Castellón/Castelló;055;Chodos/Xodos;106;65;41
12;Castellón/Castelló;056;Chóvar;288;148;140
12;Castellón/Castelló;045;Cinctorres;400;198;202
12;Castellón/Castelló;046;Cirat;206;114;92
12;Castellón/Castelló;048;Cortes de Arenoso;300;161;139
12;Castellón/Castelló;049;Costur;518;272;246
12;Castellón/Castelló;050;Coves de Vinromà, les;1806;904;902
12;Castellón/Castelló;051;Culla;481;241;240
12;Castellón/Castelló;057;Eslida;725;367;358
12;Castellón/Castelló;058;Espadilla;69;42;27
12;Castellón/Castelló;059;Fanzara;273;140;133
12;Castellón/Castelló;060;Figueroles;523;261;262
12;Castellón/Castelló;061;Forcall;456;223;233
12;Castellón/Castelló;063;Fuente la Reina;51;29;22
12;Castellón/Castelló;064;Fuentes de Ayódar;89;52;37
12;Castellón/Castelló;065;Gaibiel;181;97;84
12;Castellón/Castelló;067;Geldo;633;313;320
12;Castellón/Castelló;068;Herbés;44;26;18
12;Castellón/Castelló;069;Higueras;48;25;23
12;Castellón/Castelló;070;Jana, la;676;346;330
12;Castellón/Castelló;071;Jérica;1559;801;758
12;Castellón/Castelló;074;Llosa, la;982;479;503
12;Castellón/Castelló;072;Llucena/Lucena del Cid;1315;655;660
12;Castellón/Castelló;073;Ludiente;149;82;67
12;Castellón/Castelló;075;Mata de Morella, la;160;88;72
12;Castellón/Castelló;076;Matet;83;45;38
12;Castellón/Castelló;077;Moncofa;6707;3459;3248
12;Castellón/Castelló;078;Montán;368;183;185
12;Castellón/Castelló;079;Montanejos;564;292;272
12;Castellón/Castelló;080;Morella;2416;1184;1232
12;Castellón/Castelló;081;Navajas;720;373;347
12;Castellón/Castelló;082;Nules;13236;6631;6605
12;Castellón/Castelló;083;Olocau del Rey;120;64;56
12;Castellón/Castelló;084;Onda;24980;12484;12496
12;Castellón/Castelló;085;Oropesa del Mar/Orpesa;9339;4751;4588
12;Castellón/Castelló;087;Palanques;34;20;14
12;Castellón/Castelló;088;Pavías;68;43;25
12;Castellón/Castelló;089;Peníscola/Peñíscola;7683;3887;3796
12;Castellón/Castelló;090;Pina de Montalgrao;110;57;53
12;Castellón/Castelló;093;Pobla de Benifassà, la;199;113;86
12;Castellón/Castelló;094;Pobla Tornesa, la;1212;620;592
12;Castellón/Castelló;091;Portell de Morella;188;94;94
12;Castellón/Castelló;092;Puebla de Arenoso;152;81;71
12;Castellón/Castelló;095;Ribesalbes;1163;602;561
12;Castellón/Castelló;096;Rossell;912;482;430
12;Castellón/Castelló;097;Sacañet;62;42;20
12;Castellón/Castelló;098;Salzadella, la;700;361;339
12;Castellón/Castelló;101;San Rafael del Río;466;233;233
12;Castellón/Castelló;902;Sant Joan de Moró;3232;1676;1556
12;Castellón/Castelló;099;Sant Jordi/San Jorge;990;524;466
12;Castellón/Castelló;100;Sant Mateu;1952;969;983
12;Castellón/Castelló;102;Santa Magdalena de Pulpis;754;391;363
12;Castellón/Castelló;104;Segorbe;9097;4509;4588
12;Castellón/Castelló;103;Serratella, la;95;49;46
12;Castellón/Castelló;105;Sierra Engarcerán;988;520;468
12;Castellón/Castelló;106;Soneja;1456;720;736
12;Castellón/Castelló;107;Sot de Ferrer;409;211;198
12;Castellón/Castelló;108;Sueras/Suera;524;277;247
12;Castellón/Castelló;109;Tales;801;409;392
12;Castellón/Castelló;110;Teresa;247;132;115
12;Castellón/Castelló;111;Tírig;420;213;207
12;Castellón/Castelló;112;Todolella;141;84;57
12;Castellón/Castelló;113;Toga;96;50;46
12;Castellón/Castelló;114;Torás;232;128;104
12;Castellón/Castelló;115;Toro, El;241;136;105
12;Castellón/Castelló;116;Torralba del Pinar;61;27;34
12;Castellón/Castelló;119;Torre d'En Besora, la;167;95;72
12;Castellón/Castelló;120;Torre d'en Doménec, la;162;84;78
12;Castellón/Castelló;117;Torreblanca;5574;2835;2739
12;Castellón/Castelló;118;Torrechiva;89;48;41
12;Castellón/Castelló;121;Traiguera;1367;694;673
12;Castellón/Castelló;122;Useras/Useres, les;959;498;461
12;Castellón/Castelló;124;Vall d'Alba;2856;1495;1361
12;Castellón/Castelló;125;Vall de Almonacid;263;130;133
12;Castellón/Castelló;126;Vall d'Uixó, la;31681;15613;16068
12;Castellón/Castelló;123;Vallat;51;25;26
12;Castellón/Castelló;127;Vallibona;66;39;27
12;Castellón/Castelló;128;Vilafamés;1829;1000;829
12;Castellón/Castelló;129;Vilafranca/Villafranca del Cid;2197;1086;1111
12;Castellón/Castelló;132;Vilanova d'Alcolea;569;293;276
12;Castellón/Castelló;134;Vilar de Canes;169;88;81
12;Castellón/Castelló;135;Vila-real;51293;25488;25805
12;Castellón/Castelló;136;Vilavella, la;3125;1554;1571
12;Castellón/Castelló;130;Villahermosa del Río;484;271;213
12;Castellón/Castelló;131;Villamalur;102;65;37
12;Castellón/Castelló;133;Villanueva de Viver;60;33;27
12;Castellón/Castelló;137;Villores;42;21;21
12;Castellón/Castelló;138;Vinaròs;28833;14238;14595
12;Castellón/Castelló;139;Vistabella del Maestrat;333;184;149
12;Castellón/Castelló;140;Viver;1572;823;749
12;Castellón/Castelló;052;Xert;688;332;356
12;Castellón/Castelló;141;Zorita del Maestrazgo;111;58;53
12;Castellón/Castelló;142;Zucaina;162;91;71
51;Ceuta;001;Ceuta;84202;42542;41660
13;Ciudad Real;001;Abenójar;1351;701;650
13;Ciudad Real;002;Agudo;1657;832;825
13;Ciudad Real;003;Alamillo;476;246;230
13;Ciudad Real;004;Albaladejo;1108;568;540
13;Ciudad Real;005;Alcázar de San Juan;30766;14979;15787
13;Ciudad Real;006;Alcoba;542;276;266
13;Ciudad Real;007;Alcolea de Calatrava;1387;707;680
13;Ciudad Real;008;Alcubillas;461;226;235
13;Ciudad Real;009;Aldea del Rey;1631;824;807
13;Ciudad Real;010;Alhambra;1005;507;498
13;Ciudad Real;011;Almadén;5200;2475;2725
13;Ciudad Real;012;Almadenejos;405;212;193
13;Ciudad Real;013;Almagro;8905;4389;4516
13;Ciudad Real;014;Almedina;500;270;230
13;Ciudad Real;015;Almodóvar del Campo;5983;3008;2975
13;Ciudad Real;016;Almuradiel;761;372;389
13;Ciudad Real;017;Anchuras;295;154;141
13;Ciudad Real;903;Arenales de San Gregorio;588;305;283
13;Ciudad Real;018;Arenas de San Juan;1011;514;497
13;Ciudad Real;019;Argamasilla de Alba;6955;3499;3456
13;Ciudad Real;020;Argamasilla de Calatrava;5841;2920;2921
13;Ciudad Real;021;Arroba de los Montes;421;231;190
13;Ciudad Real;022;Ballesteros de Calatrava;376;190;186
13;Ciudad Real;023;Bolaños de Calatrava;12019;6174;5845
13;Ciudad Real;024;Brazatortas;995;513;482
13;Ciudad Real;025;Cabezarados;312;168;144
13;Ciudad Real;026;Cabezarrubias del Puerto;473;249;224
13;Ciudad Real;027;Calzada de Calatrava;3630;1802;1828
13;Ciudad Real;028;Campo de Criptana;13312;6642;6670
13;Ciudad Real;029;Cañada de Calatrava;100;58;42
13;Ciudad Real;030;Caracuel de Calatrava;122;69;53
13;Ciudad Real;031;Carrión de Calatrava;3099;1552;1547
13;Ciudad Real;032;Carrizosa;1188;611;577
13;Ciudad Real;033;Castellar de Santiago;1862;956;906
13;Ciudad Real;038;Chillón;1790;867;923
13;Ciudad Real;034;Ciudad Real;75504;35773;39731
13;Ciudad Real;035;Corral de Calatrava;1117;537;580
13;Ciudad Real;036;Cortijos, Los;877;470;407
13;Ciudad Real;037;Cózar;952;483;469
13;Ciudad Real;039;Daimiel;17916;8980;8936
13;Ciudad Real;040;Fernán Caballero;985;503;482
13;Ciudad Real;041;Fontanarejo;253;144;109
13;Ciudad Real;042;Fuencaliente;1024;528;496
13;Ciudad Real;043;Fuenllana;211;112;99
13;Ciudad Real;044;Fuente el Fresno;3208;1657;1551
13;Ciudad Real;045;Granátula de Calatrava;717;356;361
13;Ciudad Real;046;Guadalmez;697;334;363
13;Ciudad Real;047;Herencia;8456;4311;4145
13;Ciudad Real;048;Hinojosas de Calatrava;522;269;253
13;Ciudad Real;049;Horcajo de los Montes;833;432;401
13;Ciudad Real;050;Labores, Las;558;281;277
13;Ciudad Real;904;Llanos del Caudillo;683;337;346
13;Ciudad Real;051;Luciana;364;198;166
13;Ciudad Real;052;Malagón;7881;3880;4001
13;Ciudad Real;053;Manzanares;17962;8892;9070
13;Ciudad Real;054;Membrilla;5942;2984;2958
13;Ciudad Real;055;Mestanza;669;343;326
13;Ciudad Real;056;Miguelturra;15498;7792;7706
13;Ciudad Real;057;Montiel;1294;676;618
13;Ciudad Real;058;Moral de Calatrava;5208;2640;2568
13;Ciudad Real;059;Navalpino;221;116;105
13;Ciudad Real;060;Navas de Estena;293;162;131
13;Ciudad Real;061;Pedro Muñoz;7285;3672;3613
13;Ciudad Real;062;Picón;668;345;323
13;Ciudad Real;063;Piedrabuena;4379;2226;2153
13;Ciudad Real;064;Poblete;2667;1375;1292
13;Ciudad Real;065;Porzuna;3465;1781;1684
13;Ciudad Real;066;Pozuelo de Calatrava;3586;1833;1753
13;Ciudad Real;067;Pozuelos de Calatrava, Los;359;189;170
13;Ciudad Real;068;Puebla de Don Rodrigo;1162;639;523
13;Ciudad Real;069;Puebla del Príncipe;686;358;328
13;Ciudad Real;070;Puerto Lápice;891;445;446
13;Ciudad Real;071;Puertollano;46607;22549;24058
13;Ciudad Real;072;Retuerta del Bullaque;927;509;418
13;Ciudad Real;901;Robledo, El;1053;551;502
13;Ciudad Real;902;Ruidera;549;268;281
13;Ciudad Real;073;Saceruela;564;298;266
13;Ciudad Real;074;San Carlos del Valle;1109;566;543
13;Ciudad Real;075;San Lorenzo de Calatrava;207;116;91
13;Ciudad Real;076;Santa Cruz de los Cáñamos;515;249;266
13;Ciudad Real;077;Santa Cruz de Mudela;4085;2026;2059
13;Ciudad Real;078;Socuéllamos;12079;6090;5989
13;Ciudad Real;080;Solana del Pino;314;168;146
13;Ciudad Real;079;Solana, La;15419;7807;7612
13;Ciudad Real;081;Terrinches;653;338;315
13;Ciudad Real;082;Tomelloso;36168;17972;18196
13;Ciudad Real;083;Torralba de Calatrava;2966;1482;1484
13;Ciudad Real;084;Torre de Juan Abad;1000;491;509
13;Ciudad Real;085;Torrenueva;2667;1336;1331
13;Ciudad Real;086;Valdemanco del Esteras;168;88;80
13;Ciudad Real;087;Valdepeñas;30252;14766;15486
13;Ciudad Real;088;Valenzuela de Calatrava;674;312;362
13;Ciudad Real;089;Villahermosa;1790;877;913
13;Ciudad Real;090;Villamanrique;1128;553;575
13;Ciudad Real;091;Villamayor de Calatrava;620;310;310
13;Ciudad Real;092;Villanueva de la Fuente;2033;1043;990
13;Ciudad Real;093;Villanueva de los Infantes;4869;2427;2442
13;Ciudad Real;094;Villanueva de San Carlos;291;154;137
13;Ciudad Real;095;Villar del Pozo;61;34;27
13;Ciudad Real;096;Villarrubia de los Ojos;9762;4867;4895
13;Ciudad Real;097;Villarta de San Juan;2739;1382;1357
13;Ciudad Real;098;Viso del Marqués;2256;1094;1162
14;Córdoba;001;Adamuz;4137;2124;2013
14;Córdoba;002;Aguilar de la Frontera;13382;6679;6703
14;Córdoba;003;Alcaracejos;1470;717;753
14;Córdoba;004;Almedinilla;2370;1183;1187
14;Córdoba;005;Almodóvar del Río;7932;3961;3971
14;Córdoba;006;Añora;1530;757;773
14;Córdoba;007;Baena;19045;9620;9425
14;Córdoba;008;Belalcázar;3235;1563;1672
14;Córdoba;009;Belmez;2921;1420;1501
14;Córdoba;010;Benamejí;4963;2467;2496
14;Córdoba;011;Blázquez, Los;664;339;325
14;Córdoba;012;Bujalance;7320;3641;3679
14;Córdoba;013;Cabra;20347;9931;10416
14;Córdoba;014;Cañete de las Torres;2923;1509;1414
14;Córdoba;015;Carcabuey;2371;1203;1168
14;Córdoba;016;Cardeña;1471;735;736
14;Córdoba;017;Carlota, La;14079;7020;7059
14;Córdoba;018;Carpio, El;4363;2159;2204
14;Córdoba;019;Castro del Río;7767;3835;3932
14;Córdoba;020;Conquista;366;182;184
14;Córdoba;021;Córdoba;326039;156523;169516
14;Córdoba;022;Doña Mencía;4615;2244;2371
14;Córdoba;023;Dos Torres;2394;1192;1202
14;Córdoba;024;Encinas Reales;2254;1117;1137
14;Córdoba;025;Espejo;3289;1651;1638
14;Córdoba;026;Espiel;2405;1206;1199
14;Córdoba;027;Fernán-Núñez;9651;4828;4823
14;Córdoba;901;Fuente Carreteros;1148;592;556
14;Córdoba;028;Fuente la Lancha;342;171;171
14;Córdoba;029;Fuente Obejuna;4501;2324;2177
14;Córdoba;030;Fuente Palmera;9766;4871;4895
14;Córdoba;031;Fuente-Tójar;666;323;343
14;Córdoba;032;Granjuela, La;439;222;217
14;Córdoba;033;Guadalcázar;1559;780;779
14;Córdoba;902;Guijarrosa, La;1379;702;677
14;Córdoba;034;Guijo, El;352;181;171
14;Córdoba;035;Hinojosa del Duque;6707;3305;3402
14;Córdoba;036;Hornachuelos;4480;2234;2246
14;Córdoba;037;Iznájar;4134;2078;2056
14;Córdoba;038;Lucena;42733;21259;21474
14;Córdoba;039;Luque;2976;1499;1477
14;Córdoba;040;Montalbán de Córdoba;4467;2203;2264
14;Córdoba;041;Montemayor;3856;1925;1931
14;Córdoba;042;Montilla;22739;11293;11446
14;Córdoba;043;Montoro;9293;4591;4702
14;Córdoba;044;Monturque;1943;963;980
14;Córdoba;045;Moriles;3701;1863;1838
14;Córdoba;046;Nueva Carteya;5341;2715;2626
14;Córdoba;047;Obejo;2008;1057;951
14;Córdoba;048;Palenciana;1465;741;724
14;Córdoba;049;Palma del Río;20928;10406;10522
14;Córdoba;050;Pedro Abad;2815;1420;1395
14;Córdoba;051;Pedroche;1482;738;744
14;Córdoba;052;Peñarroya-Pueblonuevo;10561;5106;5455
14;Córdoba;053;Posadas;7318;3625;3693
14;Córdoba;054;Pozoblanco;17204;8360;8844
14;Córdoba;055;Priego de Córdoba;22367;10919;11448
14;Córdoba;056;Puente Genil;29943;14827;15116
14;Córdoba;057;Rambla, La;7529;3743;3786
14;Córdoba;058;Rute;9898;4936;4962
14;Córdoba;059;San Sebastián de los Ballesteros;804;408;396
14;Córdoba;061;Santa Eufemia;743;372;371
14;Córdoba;060;Santaella;4614;2316;2298
14;Córdoba;062;Torrecampo;1040;510;530
14;Córdoba;063;Valenzuela;1118;561;557
14;Córdoba;064;Valsequillo;348;170;178
14;Córdoba;065;Victoria, La;2289;1142;1147
14;Córdoba;066;Villa del Río;7067;3510;3557
14;Córdoba;067;Villafranca de Córdoba;4860;2489;2371
14;Córdoba;068;Villaharta;621;304;317
14;Córdoba;069;Villanueva de Córdoba;8671;4309;4362
14;Córdoba;070;Villanueva del Duque;1448;739;709
14;Córdoba;071;Villanueva del Rey;1015;496;519
14;Córdoba;072;Villaralto;1118;566;552
14;Córdoba;073;Villaviciosa de Córdoba;3200;1640;1560
14;Córdoba;074;Viso, El;2517;1256;1261
14;Córdoba;075;Zuheros;635;320;315
15;Coruña, A;001;Abegondo;5398;2665;2733
15;Coruña, A;002;Ames;32104;15444;16660
15;Coruña, A;003;Aranga;1834;948;886
15;Coruña, A;004;Ares;5829;2859;2970
15;Coruña, A;005;Arteixo;32738;16251;16487
15;Coruña, A;006;Arzúa;6011;2996;3015
15;Coruña, A;007;Baña, A;3415;1611;1804
15;Coruña, A;008;Bergondo;6661;3242;3419
15;Coruña, A;009;Betanzos;13053;6189;6864
15;Coruña, A;010;Boimorto;1959;988;971
15;Coruña, A;011;Boiro;18884;9176;9708
15;Coruña, A;012;Boqueixón;4206;2075;2131
15;Coruña, A;013;Brión;7923;3805;4118
15;Coruña, A;014;Cabana de Bergantiños;4216;2033;2183
15;Coruña, A;015;Cabanas;3274;1598;1676
15;Coruña, A;016;Camariñas;5209;2540;2669
15;Coruña, A;017;Cambre;24594;11953;12641
15;Coruña, A;018;Capela, A;1221;605;616
15;Coruña, A;019;Carballo;31429;15377;16052
15;Coruña, A;901;Cariño;3775;1872;1903
15;Coruña, A;020;Carnota;3899;1844;2055
15;Coruña, A;021;Carral;6473;3176;3297
15;Coruña, A;022;Cedeira;6676;3326;3350
15;Coruña, A;023;Cee;7550;3606;3944
15;Coruña, A;024;Cerceda;5008;2474;2534
15;Coruña, A;025;Cerdido;1087;532;555
15;Coruña, A;027;Coirós;1853;920;933
15;Coruña, A;028;Corcubión;1590;783;807
15;Coruña, A;029;Coristanco;5950;2851;3099
15;Coruña, A;030;Coruña, A;247604;114776;132828
15;Coruña, A;031;Culleredo;30685;14804;15881
15;Coruña, A;032;Curtis;4053;2042;2011
15;Coruña, A;033;Dodro;2750;1324;1426
15;Coruña, A;034;Dumbría;2935;1410;1525
15;Coruña, A;035;Fene;12868;6150;6718
15;Coruña, A;036;Ferrol;65560;30885;34675
15;Coruña, A;037;Fisterra;4697;2381;2316
15;Coruña, A;038;Frades;2302;1146;1156
15;Coruña, A;039;Irixoa;1340;674;666
15;Coruña, A;041;Laracha, A;11406;5619;5787
15;Coruña, A;040;Laxe;2990;1501;1489
15;Coruña, A;042;Lousame;3268;1624;1644
15;Coruña, A;043;Malpica de Bergantiños;5352;2620;2732
15;Coruña, A;044;Mañón;1319;651;668
15;Coruña, A;045;Mazaricos;3841;1821;2020
15;Coruña, A;046;Melide;7419;3665;3754
15;Coruña, A;047;Mesía;2497;1236;1261
15;Coruña, A;048;Miño;6277;3144;3133
15;Coruña, A;049;Moeche;1186;569;617
15;Coruña, A;050;Monfero;1907;984;923
15;Coruña, A;051;Mugardos;5215;2534;2681
15;Coruña, A;053;Muros;8427;4070;4357
15;Coruña, A;052;Muxía;4596;2224;2372
15;Coruña, A;054;Narón;39056;18879;20177
15;Coruña, A;055;Neda;5023;2448;2575
15;Coruña, A;056;Negreira;6788;3282;3506
15;Coruña, A;057;Noia;14274;6840;7434
15;Coruña, A;058;Oleiros;36534;17654;18880
15;Coruña, A;059;Ordes;12625;6158;6467
15;Coruña, A;060;Oroso;7533;3723;3810
15;Coruña, A;061;Ortigueira;5633;2675;2958
15;Coruña, A;062;Outes;6155;2965;3190
15;Coruña, A;902;Oza-Cesuras;5096;2573;2523
15;Coruña, A;064;Paderne;2383;1175;1208
15;Coruña, A;065;Padrón;8366;4035;4331
15;Coruña, A;066;Pino, O;4652;2348;2304
15;Coruña, A;067;Pobra do Caramiñal, A;9318;4544;4774
15;Coruña, A;068;Ponteceso;5497;2755;2742
15;Coruña, A;069;Pontedeume;7753;3699;4054
15;Coruña, A;070;Pontes de García Rodríguez, As;10068;4902;5166
15;Coruña, A;071;Porto do Son;9142;4548;4594
15;Coruña, A;072;Rianxo;11013;5368;5645
15;Coruña, A;073;Ribeira;26848;13239;13609
15;Coruña, A;074;Rois;4505;2137;2368
15;Coruña, A;075;Sada;16186;7919;8267
15;Coruña, A;076;San Sadurniño;2784;1378;1406
15;Coruña, A;077;Santa Comba;9362;4536;4826
15;Coruña, A;078;Santiago de Compostela;97848;45472;52376
15;Coruña, A;079;Santiso;1544;802;742
15;Coruña, A;080;Sobrado;1730;900;830
15;Coruña, A;081;Somozas, As;1083;543;540
15;Coruña, A;082;Teo;18632;9135;9497
15;Coruña, A;083;Toques;1107;574;533
15;Coruña, A;084;Tordoia;3259;1555;1704
15;Coruña, A;085;Touro;3516;1748;1768
15;Coruña, A;086;Trazo;3013;1485;1528
15;Coruña, A;088;Val do Dubra;3851;1846;2005
15;Coruña, A;087;Valdoviño;6542;3175;3367
15;Coruña, A;089;Vedra;5007;2462;2545
15;Coruña, A;091;Vilarmaior;1209;618;591
15;Coruña, A;090;Vilasantar;1211;633;578
15;Coruña, A;092;Vimianzo;6963;3348;3615
15;Coruña, A;093;Zas;4393;2112;2281
16;Cuenca;001;Abia de la Obispalía;61;37;24
16;Cuenca;002;Acebrón, El;231;111;120
16;Cuenca;003;Alarcón;156;69;87
16;Cuenca;004;Albaladejo del Cuende;245;133;112
16;Cuenca;005;Albalate de las Nogueras;257;137;120
16;Cuenca;006;Albendea;125;61;64
16;Cuenca;007;Alberca de Záncara, La;1608;824;784
16;Cuenca;008;Alcalá de la Vega;90;52;38
16;Cuenca;009;Alcantud;48;27;21
16;Cuenca;010;Alcázar del Rey;142;73;69
16;Cuenca;011;Alcohujate;26;14;12
16;Cuenca;012;Alconchel de la Estrella;85;49;36
16;Cuenca;013;Algarra;24;11;13
16;Cuenca;014;Aliaguilla;632;327;305
16;Cuenca;015;Almarcha, La;378;207;171
16;Cuenca;016;Almendros;239;134;105
16;Cuenca;017;Almodóvar del Pinar;393;212;181
16;Cuenca;018;Almonacid del Marquesado;432;221;211
16;Cuenca;019;Altarejos;188;100;88
16;Cuenca;020;Arandilla del Arroyo;7;5;2
16;Cuenca;905;Arcas;1775;894;881
16;Cuenca;022;Arcos de la Sierra;77;46;31
16;Cuenca;024;Arguisuelas;136;69;67
16;Cuenca;025;Arrancacepas;25;14;11
16;Cuenca;026;Atalaya del Cañavate;98;52;46
16;Cuenca;027;Barajas de Melo;940;505;435
16;Cuenca;029;Barchín del Hoyo;95;61;34
16;Cuenca;030;Bascuñana de San Pedro;23;20;3
16;Cuenca;031;Beamud;39;20;19
16;Cuenca;032;Belinchón;352;181;171
16;Cuenca;033;Belmonte;1870;929;941
16;Cuenca;034;Belmontejo;154;88;66
16;Cuenca;035;Beteta;236;115;121
16;Cuenca;036;Boniches;139;70;69
16;Cuenca;038;Buciegas;32;22;10
16;Cuenca;039;Buenache de Alarcón;463;243;220
16;Cuenca;040;Buenache de la Sierra;105;59;46
16;Cuenca;041;Buendía;408;219;189
16;Cuenca;042;Campillo de Altobuey;1265;628;637
16;Cuenca;043;Campillos-Paravientos;104;60;44
16;Cuenca;044;Campillos-Sierra;38;18;20
16;Cuenca;901;Campos del Paraíso;718;369;349
16;Cuenca;045;Canalejas del Arroyo;177;97;80
16;Cuenca;046;Cañada del Hoyo;232;120;112
16;Cuenca;047;Cañada Juncosa;243;131;112
16;Cuenca;048;Cañamares;457;251;206
16;Cuenca;049;Cañavate, El;132;65;67
16;Cuenca;050;Cañaveras;247;122;125
16;Cuenca;051;Cañaveruelas;126;65;61
16;Cuenca;052;Cañete;764;394;370
16;Cuenca;053;Cañizares;432;233;199
16;Cuenca;055;Carboneras de Guadazaón;795;409;386
16;Cuenca;056;Cardenete;486;264;222
16;Cuenca;057;Carrascosa;67;40;27
16;Cuenca;058;Carrascosa de Haro;100;50;50
16;Cuenca;060;Casas de Benítez;823;402;421
16;Cuenca;061;Casas de Fernando Alonso;1140;593;547
16;Cuenca;062;Casas de Garcimolina;29;19;10
16;Cuenca;063;Casas de Guijarro;112;61;51
16;Cuenca;064;Casas de Haro;827;439;388
16;Cuenca;065;Casas de los Pinos;435;213;222
16;Cuenca;066;Casasimarro;3103;1596;1507
16;Cuenca;067;Castejón;135;74;61
16;Cuenca;068;Castillejo de Iniesta;151;83;68
16;Cuenca;070;Castillejo-Sierra;31;17;14
16;Cuenca;072;Castillo de Garcimuñoz;131;76;55
16;Cuenca;071;Castillo-Albaráñez;21;10;11
16;Cuenca;073;Cervera del Llano;218;115;103
16;Cuenca;023;Chillarón de Cuenca;632;327;305
16;Cuenca;081;Chumillas;58;30;28
16;Cuenca;074;Cierva, La;31;17;14
16;Cuenca;078;Cuenca;54621;25956;28665
16;Cuenca;079;Cueva del Hierro;32;22;10
16;Cuenca;082;Enguídanos;313;162;151
16;Cuenca;083;Fresneda de Altarejos;37;19;18
16;Cuenca;084;Fresneda de la Sierra;51;29;22
16;Cuenca;085;Frontera, La;148;79;69
16;Cuenca;086;Fuente de Pedro Naharro;1215;632;583
16;Cuenca;087;Fuentelespino de Haro;268;134;134
16;Cuenca;088;Fuentelespino de Moya;104;56;48
16;Cuenca;904;Fuentenava de Jábaga;489;261;228
16;Cuenca;089;Fuentes;458;238;220
16;Cuenca;091;Fuertescusa;60;33;27
16;Cuenca;092;Gabaldón;178;104;74
16;Cuenca;093;Garaballa;55;28;27
16;Cuenca;094;Gascueña;143;82;61
16;Cuenca;095;Graja de Campalbo;91;50;41
16;Cuenca;096;Graja de Iniesta;358;190;168
16;Cuenca;097;Henarejos;134;70;64
16;Cuenca;098;Herrumblar, El;677;346;331
16;Cuenca;099;Hinojosa, La;180;95;85
16;Cuenca;100;Hinojosos, Los;784;390;394
16;Cuenca;101;Hito, El;135;76;59
16;Cuenca;102;Honrubia;1531;761;770
16;Cuenca;103;Hontanaya;245;141;104
16;Cuenca;104;Hontecillas;56;30;26
16;Cuenca;106;Horcajo de Santiago;3504;1773;1731
16;Cuenca;107;Huélamo;87;48;39
16;Cuenca;108;Huelves;80;43;37
16;Cuenca;109;Huérguina;51;28;23
16;Cuenca;110;Huerta de la Obispalía;117;67;50
16;Cuenca;111;Huerta del Marquesado;183;102;81
16;Cuenca;112;Huete;1748;903;845
16;Cuenca;113;Iniesta;4320;2119;2201
16;Cuenca;115;Laguna del Marquesado;51;30;21
16;Cuenca;116;Lagunaseca;66;39;27
16;Cuenca;117;Landete;1249;636;613
16;Cuenca;118;Ledaña;1561;765;796
16;Cuenca;119;Leganiel;186;97;89
16;Cuenca;121;Majadas, Las;234;123;111
16;Cuenca;122;Mariana;298;154;144
16;Cuenca;123;Masegosa;62;35;27
16;Cuenca;124;Mesas, Las;2317;1188;1129
16;Cuenca;125;Minglanilla;2198;1127;1071
16;Cuenca;126;Mira;886;446;440
16;Cuenca;128;Monreal del Llano;53;30;23
16;Cuenca;129;Montalbanejo;99;51;48
16;Cuenca;130;Montalbo;655;340;315
16;Cuenca;131;Monteagudo de las Salinas;126;72;54
16;Cuenca;132;Mota de Altarejos;31;20;11
16;Cuenca;133;Mota del Cuervo;6055;3024;3031
16;Cuenca;134;Motilla del Palancar;5917;2937;2980
16;Cuenca;135;Moya;136;80;56
16;Cuenca;137;Narboneta;38;22;16
16;Cuenca;139;Olivares de Júcar;308;159;149
16;Cuenca;140;Olmeda de la Cuesta;22;14;8
16;Cuenca;141;Olmeda del Rey;131;66;65
16;Cuenca;142;Olmedilla de Alarcón;146;84;62
16;Cuenca;143;Olmedilla de Eliz;14;11;3
16;Cuenca;145;Osa de la Vega;465;241;224
16;Cuenca;146;Pajarón;79;37;42
16;Cuenca;147;Pajaroncillo;63;38;25
16;Cuenca;148;Palomares del Campo;572;294;278
16;Cuenca;149;Palomera;160;79;81
16;Cuenca;150;Paracuellos;93;49;44
16;Cuenca;151;Paredes;58;34;24
16;Cuenca;152;Parra de las Vegas, La;35;25;10
16;Cuenca;153;Pedernoso, El;1140;563;577
16;Cuenca;154;Pedroñeras, Las;6639;3397;3242
16;Cuenca;155;Peral, El;640;357;283
16;Cuenca;156;Peraleja, La;87;54;33
16;Cuenca;157;Pesquera, La;202;111;91
16;Cuenca;158;Picazo, El;673;345;328
16;Cuenca;159;Pinarejo;203;105;98
16;Cuenca;160;Pineda de Gigüela;58;36;22
16;Cuenca;161;Piqueras del Castillo;48;27;21
16;Cuenca;162;Portalrubio de Guadamejud;30;14;16
16;Cuenca;163;Portilla;61;33;28
16;Cuenca;165;Poyatos;53;27;26
16;Cuenca;166;Pozoamargo;290;154;136
16;Cuenca;908;Pozorrubielos de la Mancha;188;97;91
16;Cuenca;167;Pozorrubio de Santiago;308;147;161
16;Cuenca;169;Pozuelo, El;44;29;15
16;Cuenca;170;Priego;896;454;442
16;Cuenca;171;Provencio, El;2432;1209;1223
16;Cuenca;172;Puebla de Almenara;344;183;161
16;Cuenca;174;Puebla del Salvador;187;103;84
16;Cuenca;175;Quintanar del Rey;7714;3976;3738
16;Cuenca;176;Rada de Haro;57;33;24
16;Cuenca;177;Reíllo;116;60;56
16;Cuenca;181;Rozalén del Monte;65;31;34
16;Cuenca;185;Saceda-Trasierra;43;30;13
16;Cuenca;186;Saelices;458;236;222
16;Cuenca;187;Salinas del Manzano;65;39;26
16;Cuenca;188;Salmeroncillos;101;56;45
16;Cuenca;189;Salvacañete;305;163;142
16;Cuenca;190;San Clemente;7015;3528;3487
16;Cuenca;191;San Lorenzo de la Parrilla;1040;539;501
16;Cuenca;192;San Martín de Boniches;42;22;20
16;Cuenca;193;San Pedro Palmiches;53;30;23
16;Cuenca;194;Santa Cruz de Moya;207;110;97
16;Cuenca;196;Santa María de los Llanos;686;361;325
16;Cuenca;195;Santa María del Campo Rus;565;289;276
16;Cuenca;197;Santa María del Val;68;40;28
16;Cuenca;198;Sisante;1605;812;793
16;Cuenca;199;Solera de Gabaldón;27;15;12
16;Cuenca;909;Sotorribas;700;365;335
16;Cuenca;202;Talayuelas;864;458;406
16;Cuenca;203;Tarancón;15505;7685;7820
16;Cuenca;204;Tébar;279;150;129
16;Cuenca;205;Tejadillos;115;54;61
16;Cuenca;206;Tinajas;194;104;90
16;Cuenca;209;Torralba;111;67;44
16;Cuenca;211;Torrejoncillo del Rey;351;187;164
16;Cuenca;212;Torrubia del Campo;257;127;130
16;Cuenca;213;Torrubia del Castillo;38;24;14
16;Cuenca;215;Tragacete;250;141;109
16;Cuenca;216;Tresjuncos;278;148;130
16;Cuenca;217;Tribaldos;103;55;48
16;Cuenca;218;Uclés;212;114;98
16;Cuenca;219;Uña;79;41;38
16;Cuenca;906;Valdecolmenas, Los;68;45;23
16;Cuenca;224;Valdemeca;77;44;33
16;Cuenca;225;Valdemorillo de la Sierra;63;36;27
16;Cuenca;227;Valdemoro-Sierra;108;62;46
16;Cuenca;228;Valdeolivas;193;120;73
16;Cuenca;902;Valdetórtola;126;73;53
16;Cuenca;903;Valeras, Las;1494;793;701
16;Cuenca;231;Valhermoso de la Fuente;52;25;27
16;Cuenca;173;Valle de Altomira, El;182;97;85
16;Cuenca;234;Valsalobre;22;12;10
16;Cuenca;236;Valverde de Júcar;1084;550;534
16;Cuenca;237;Valverdejo;88;47;41
16;Cuenca;238;Vara de Rey;496;256;240
16;Cuenca;239;Vega del Codorno;129;79;50
16;Cuenca;240;Vellisca;100;60;40
16;Cuenca;242;Villaconejos de Trabaque;332;168;164
16;Cuenca;243;Villaescusa de Haro;481;244;237
16;Cuenca;244;Villagarcía del Llano;747;378;369
16;Cuenca;245;Villalba de la Sierra;444;219;225
16;Cuenca;246;Villalba del Rey;513;277;236
16;Cuenca;247;Villalgordo del Marquesado;82;43;39
16;Cuenca;248;Villalpardo;1005;506;499
16;Cuenca;249;Villamayor de Santiago;2521;1273;1248
16;Cuenca;250;Villanueva de Guadamejud;68;42;26
16;Cuenca;251;Villanueva de la Jara;2282;1161;1121
16;Cuenca;253;Villar de Cañas;375;198;177
16;Cuenca;254;Villar de Domingo García;212;101;111
16;Cuenca;255;Villar de la Encina;148;82;66
16;Cuenca;263;Villar de Olalla;1285;684;601
16;Cuenca;258;Villar del Humo;191;102;89
16;Cuenca;259;Villar del Infantado;44;25;19
16;Cuenca;910;Villar y Velasco;75;43;32
16;Cuenca;264;Villarejo de Fuentes;418;209;209
16;Cuenca;265;Villarejo de la Peñuela;22;11;11
16;Cuenca;266;Villarejo-Periesteban;382;190;192
16;Cuenca;269;Villares del Saz;414;211;203
16;Cuenca;270;Villarrubio;191;107;84
16;Cuenca;271;Villarta;843;412;431
16;Cuenca;272;Villas de la Ventosa;213;122;91
16;Cuenca;273;Villaverde y Pasaconsol;328;172;156
16;Cuenca;274;Víllora;109;58;51
16;Cuenca;275;Vindel;11;7;4
16;Cuenca;276;Yémeda;18;12;6
16;Cuenca;277;Zafra de Záncara;110;61;49
16;Cuenca;278;Zafrilla;56;29;27
16;Cuenca;279;Zarza de Tajo;266;148;118
16;Cuenca;280;Zarzuela;169;88;81
20;Gipuzkoa;001;Abaltzisketa;318;175;143
20;Gipuzkoa;002;Aduna;472;254;218
20;Gipuzkoa;016;Aia;2039;1078;961
20;Gipuzkoa;003;Aizarnazabal;779;395;384
20;Gipuzkoa;004;Albiztur;302;156;146
20;Gipuzkoa;005;Alegia;1768;909;859
20;Gipuzkoa;006;Alkiza;371;180;191
20;Gipuzkoa;906;Altzaga;178;86;92
20;Gipuzkoa;007;Altzo;460;237;223
20;Gipuzkoa;008;Amezketa;935;501;434
20;Gipuzkoa;009;Andoain;14691;7296;7395
20;Gipuzkoa;010;Anoeta;2085;1076;1009
20;Gipuzkoa;011;Antzuola;2102;1053;1049
20;Gipuzkoa;012;Arama;202;99;103
20;Gipuzkoa;013;Aretxabaleta;7103;3581;3522
20;Gipuzkoa;055;Arrasate/Mondragón;22073;10833;11240
20;Gipuzkoa;014;Asteasu;1561;802;759
20;Gipuzkoa;903;Astigarraga;7029;3578;3451
20;Gipuzkoa;015;Ataun;1696;877;819
20;Gipuzkoa;017;Azkoitia;11627;5783;5844
20;Gipuzkoa;018;Azpeitia;15106;7547;7559
20;Gipuzkoa;904;Baliarrain;153;86;67
20;Gipuzkoa;019;Beasain;13938;7003;6935
20;Gipuzkoa;020;Beizama;146;88;58
20;Gipuzkoa;021;Belauntza;243;132;111
20;Gipuzkoa;022;Berastegi;1075;553;522
20;Gipuzkoa;074;Bergara;14659;7267;7392
20;Gipuzkoa;023;Berrobi;601;318;283
20;Gipuzkoa;024;Bidania-Goiatz;525;285;240
20;Gipuzkoa;029;Deba;5460;2707;2753
20;Gipuzkoa;069;Donostia/San Sebastián;188240;88825;99415
20;Gipuzkoa;030;Eibar;27769;13514;14255
20;Gipuzkoa;031;Elduain;243;122;121
20;Gipuzkoa;033;Elgeta;1131;572;559
20;Gipuzkoa;032;Elgoibar;11570;5709;5861
20;Gipuzkoa;067;Errenteria;39540;19112;20428
20;Gipuzkoa;066;Errezil;578;306;272
20;Gipuzkoa;034;Eskoriatza;4106;2045;2061
20;Gipuzkoa;035;Ezkio-Itsaso;601;316;285
20;Gipuzkoa;038;Gabiria;495;265;230
20;Gipuzkoa;037;Gaintza;121;70;51
20;Gipuzkoa;907;Gaztelu;154;81;73
20;Gipuzkoa;039;Getaria;2796;1408;1388
20;Gipuzkoa;040;Hernani;20438;9990;10448
20;Gipuzkoa;041;Hernialde;303;161;142
20;Gipuzkoa;036;Hondarribia;16881;8415;8466
20;Gipuzkoa;042;Ibarra;4248;2111;2137
20;Gipuzkoa;043;Idiazabal;2293;1157;1136
20;Gipuzkoa;044;Ikaztegieta;479;247;232
20;Gipuzkoa;045;Irun;62910;30759;32151
20;Gipuzkoa;046;Irura;1852;978;874
20;Gipuzkoa;047;Itsasondo;668;347;321
20;Gipuzkoa;048;Larraul;256;144;112
20;Gipuzkoa;902;Lasarte-Oria;18594;8999;9595
20;Gipuzkoa;049;Lazkao;5830;2928;2902
20;Gipuzkoa;050;Leaburu;386;204;182
20;Gipuzkoa;051;Legazpi;8321;4204;4117
20;Gipuzkoa;052;Legorreta;1421;722;699
20;Gipuzkoa;068;Leintz-Gatzaga;217;120;97
20;Gipuzkoa;053;Lezo;6103;3057;3046
20;Gipuzkoa;054;Lizartza;617;325;292
20;Gipuzkoa;901;Mendaro;1976;1000;976
20;Gipuzkoa;057;Mutiloa;255;138;117
20;Gipuzkoa;056;Mutriku;5309;2662;2647
20;Gipuzkoa;063;Oiartzun;10309;5078;5231
20;Gipuzkoa;058;Olaberria;957;484;473
20;Gipuzkoa;059;Oñati;11497;5648;5849
20;Gipuzkoa;076;Ordizia;10503;5222;5281
20;Gipuzkoa;905;Orendain;227;111;116
20;Gipuzkoa;060;Orexa;117;66;51
20;Gipuzkoa;061;Orio;6091;3058;3033
20;Gipuzkoa;062;Ormaiztegi;1258;634;624
20;Gipuzkoa;064;Pasaia;16035;7716;8319
20;Gipuzkoa;070;Segura;1494;748;746
20;Gipuzkoa;065;Soraluze-Placencia de las Armas;3923;1969;1954
20;Gipuzkoa;071;Tolosa;19816;9543;10273
20;Gipuzkoa;072;Urnieta;6185;3108;3077
20;Gipuzkoa;077;Urretxu;6782;3341;3441
20;Gipuzkoa;073;Usurbil;6173;3088;3085
20;Gipuzkoa;075;Villabona;5876;2939;2937
20;Gipuzkoa;078;Zaldibia;1637;834;803
20;Gipuzkoa;079;Zarautz;23360;11344;12016
20;Gipuzkoa;025;Zegama;1524;768;756
20;Gipuzkoa;026;Zerain;270;131;139
20;Gipuzkoa;027;Zestoa;3772;1970;1802
20;Gipuzkoa;028;Zizurkil;3025;1526;1499
20;Gipuzkoa;081;Zumaia;10111;5024;5087
20;Gipuzkoa;080;Zumarraga;9781;4832;4949
17;Girona;001;Agullana;863;431;432
17;Girona;002;Aiguaviva;765;385;380
17;Girona;003;Albanyà;155;79;76
17;Girona;004;Albons;759;391;368
17;Girona;006;Alp;1593;823;770
17;Girona;007;Amer;2332;1144;1188
17;Girona;008;Anglès;5654;2817;2837
17;Girona;009;Arbúcies;6608;3416;3192
17;Girona;010;Argelaguer;396;207;189
17;Girona;011;Armentera, L';951;478;473
17;Girona;012;Avinyonet de Puigventós;1641;818;823
17;Girona;015;Banyoles;20053;9986;10067
17;Girona;016;Bàscara;1001;521;480
17;Girona;013;Begur;3891;1955;1936
17;Girona;018;Bellcaire d'Empordà;678;325;353
17;Girona;019;Besalú;2487;1181;1306
17;Girona;020;Bescanó;4991;2522;2469
17;Girona;021;Beuda;186;99;87
17;Girona;022;Bisbal d'Empordà, La;11159;5565;5594
17;Girona;234;Biure;241;125;116
17;Girona;023;Blanes;39914;19846;20068
17;Girona;029;Boadella i les Escaules;272;137;135
17;Girona;024;Bolvir;375;197;178
17;Girona;025;Bordils;1761;885;876
17;Girona;026;Borrassà;733;380;353
17;Girona;027;Breda;3762;1842;1920
17;Girona;028;Brunyola i Sant Martí Sapresa;389;203;186
17;Girona;031;Cabanelles;267;150;117
17;Girona;030;Cabanes;968;520;448
17;Girona;032;Cadaqués;2695;1300;1395
17;Girona;033;Caldes de Malavella;7872;3935;3937
17;Girona;034;Calonge i Sant Antoni;11331;5681;5650
17;Girona;035;Camós;677;340;337
17;Girona;036;Campdevànol;3232;1560;1672
17;Girona;037;Campelles;140;73;67
17;Girona;038;Campllong;537;264;273
17;Girona;039;Camprodon;2298;1124;1174
17;Girona;040;Canet d'Adri;729;382;347
17;Girona;041;Cantallops;309;153;156
17;Girona;042;Capmany;611;305;306
17;Girona;044;Cassà de la Selva;10410;5293;5117
17;Girona;046;Castellfollit de la Roca;947;488;459
17;Girona;047;Castelló d'Empúries;11100;5604;5496
17;Girona;048;Castell-Platja d'Aro;11030;5426;5604
17;Girona;189;Cellera de Ter, La;1950;959;991
17;Girona;049;Celrà;5561;2796;2765
17;Girona;050;Cervià de Ter;966;494;472
17;Girona;051;Cistella;282;137;145
17;Girona;054;Colera;445;217;228
17;Girona;055;Colomers;174;84;90
17;Girona;057;Corçà;1268;642;626
17;Girona;056;Cornellà del Terri;2399;1215;1184
17;Girona;058;Crespià;254;127;127
17;Girona;901;Cruïlles, Monells i Sant Sadurní de l'Heura;1270;632;638
17;Girona;060;Darnius;537;272;265
17;Girona;061;Das;234;121;113
17;Girona;062;Escala, L';10244;5187;5057
17;Girona;063;Espinelves;221;112;109
17;Girona;064;Espolla;412;204;208
17;Girona;065;Esponellà;463;234;229
17;Girona;005;Far d'Empordà, El;602;311;291
17;Girona;066;Figueres;47235;23363;23872
17;Girona;067;Flaçà;1130;551;579
17;Girona;068;Foixà;303;151;152
17;Girona;069;Fontanals de Cerdanya;437;212;225
17;Girona;070;Fontanilles;146;81;65
17;Girona;071;Fontcoberta;1469;732;737
17;Girona;902;Forallac;1695;827;868
17;Girona;073;Fornells de la Selva;2670;1333;1337
17;Girona;074;Fortià;787;395;392
17;Girona;075;Garrigàs;451;234;217
17;Girona;076;Garrigoles;167;88;79
17;Girona;077;Garriguella;853;425;428
17;Girona;078;Ger;449;222;227
17;Girona;079;Girona;103369;49809;53560
17;Girona;080;Gombrèn;192;95;97
17;Girona;081;Gualta;402;234;168
17;Girona;082;Guils de Cerdanya;549;294;255
17;Girona;083;Hostalric;4291;2158;2133
17;Girona;084;Isòvol;281;163;118
17;Girona;085;Jafre;387;209;178
17;Girona;086;Jonquera, La;3320;1661;1659
17;Girona;087;Juià;319;163;156
17;Girona;088;Lladó;844;411;433
17;Girona;089;Llagostera;8647;4373;4274
17;Girona;090;Llambilles;713;366;347
17;Girona;091;Llanars;535;274;261
17;Girona;092;Llançà;4775;2353;2422
17;Girona;093;Llers;1237;609;628
17;Girona;094;Llívia;1431;745;686
17;Girona;095;Lloret de Mar;39089;19926;19163
17;Girona;096;Llosses, Les;212;121;91
17;Girona;102;Maçanet de Cabrenys;698;352;346
17;Girona;103;Maçanet de la Selva;7066;3636;3430
17;Girona;097;Madremanya;288;137;151
17;Girona;098;Maià de Montcal;463;260;203
17;Girona;100;Masarac;288;150;138
17;Girona;101;Massanes;796;420;376
17;Girona;099;Meranges;100;55;45
17;Girona;105;Mieres;345;176;169
17;Girona;106;Mollet de Peralada;198;104;94
17;Girona;107;Molló;336;166;170
17;Girona;109;Montagut i Oix;930;481;449
17;Girona;110;Mont-ras;1680;851;829
17;Girona;111;Navata;1427;692;735
17;Girona;112;Ogassa;240;132;108
17;Girona;114;Olot;35926;17989;17937
17;Girona;115;Ordis;361;193;168
17;Girona;116;Osor;428;232;196
17;Girona;117;Palafrugell;23244;11531;11713
17;Girona;118;Palamós;18135;8873;9262
17;Girona;119;Palau de Santa Eulàlia;90;51;39
17;Girona;121;Palau-sator;310;169;141
17;Girona;120;Palau-saverdera;1456;738;718
17;Girona;123;Palol de Revardit;448;223;225
17;Girona;124;Pals;2395;1232;1163
17;Girona;125;Pardines;169;90;79
17;Girona;126;Parlavà;391;196;195
17;Girona;128;Pau;557;280;277
17;Girona;129;Pedret i Marzà;191;97;94
17;Girona;130;Pera, La;435;217;218
17;Girona;132;Peralada;1898;937;961
17;Girona;133;Planes d'Hostoles, Les;1712;866;846
17;Girona;134;Planoles;304;165;139
17;Girona;135;Pont de Molins;516;261;255
17;Girona;136;Pontós;260;141;119
17;Girona;137;Porqueres;4677;2304;2373
17;Girona;140;Port de la Selva, El;958;497;461
17;Girona;138;Portbou;1063;521;542
17;Girona;139;Preses, Les;1855;921;934
17;Girona;141;Puigcerdà;9486;4712;4774
17;Girona;142;Quart;3798;1910;1888
17;Girona;043;Queralbs;188;98;90
17;Girona;143;Rabós;184;92;92
17;Girona;144;Regencós;276;150;126
17;Girona;145;Ribes de Freser;1760;883;877
17;Girona;146;Riells i Viabrea;4153;2110;2043
17;Girona;147;Ripoll;10803;5369;5434
17;Girona;148;Riudarenes;2204;1134;1070
17;Girona;149;Riudaura;481;230;251
17;Girona;150;Riudellots de la Selva;2071;1055;1016
17;Girona;151;Riumors;246;121;125
17;Girona;152;Roses;19807;10016;9791
17;Girona;153;Rupià;273;140;133
17;Girona;154;Sales de Llierca;159;82;77
17;Girona;155;Salt;32138;16920;15218
17;Girona;157;Sant Andreu Salou;160;78;82
17;Girona;183;Sant Aniol de Finestres;345;180;165
17;Girona;158;Sant Climent Sescebes;707;439;268
17;Girona;159;Sant Feliu de Buixalleu;797;414;383
17;Girona;160;Sant Feliu de Guíxols;22097;10871;11226
17;Girona;161;Sant Feliu de Pallerols;1437;724;713
17;Girona;162;Sant Ferriol;236;125;111
17;Girona;163;Sant Gregori;3928;2017;1911
17;Girona;164;Sant Hilari Sacalm;5703;2884;2819
17;Girona;165;Sant Jaume de Llierca;871;420;451
17;Girona;167;Sant Joan de les Abadesses;3224;1595;1629
17;Girona;168;Sant Joan de Mollet;498;241;257
17;Girona;185;Sant Joan les Fonts;3044;1553;1491
17;Girona;166;Sant Jordi Desvalls;760;377;383
17;Girona;169;Sant Julià de Ramis;3576;1814;1762
17;Girona;903;Sant Julià del Llor i Bonmatí;1313;660;653
17;Girona;171;Sant Llorenç de la Muga;265;134;131
17;Girona;172;Sant Martí de Llémena;641;334;307
17;Girona;173;Sant Martí Vell;251;136;115
17;Girona;174;Sant Miquel de Campmajor;229;127;102
17;Girona;175;Sant Miquel de Fluvià;761;396;365
17;Girona;176;Sant Mori;166;84;82
17;Girona;177;Sant Pau de Segúries;688;344;344
17;Girona;178;Sant Pere Pescador;2090;1112;978
17;Girona;180;Santa Coloma de Farners;13363;6762;6601
17;Girona;181;Santa Cristina d'Aro;5287;2661;2626
17;Girona;182;Santa Llogaia d'Àlguema;368;189;179
17;Girona;184;Santa Pau;1614;837;777
17;Girona;186;Sarrià de Ter;5229;2567;2662
17;Girona;187;Saus, Camallera i Llampaies;856;426;430
17;Girona;188;Selva de Mar, La;195;105;90
17;Girona;190;Serinyà;1133;574;559
17;Girona;191;Serra de Daró;222;121;101
17;Girona;192;Setcases;170;96;74
17;Girona;193;Sils;6219;3187;3032
17;Girona;052;Siurana;171;82;89
17;Girona;194;Susqueda;93;55;38
17;Girona;195;Tallada d'Empordà, La;454;237;217
17;Girona;196;Terrades;338;166;172
17;Girona;197;Torrent;164;87;77
17;Girona;198;Torroella de Fluvià;703;367;336
17;Girona;199;Torroella de Montgrí;11836;5983;5853
17;Girona;200;Tortellà;818;391;427
17;Girona;201;Toses;168;98;70
17;Girona;202;Tossa de Mar;5818;2927;2891
17;Girona;204;Ullà;1177;648;529
17;Girona;205;Ullastret;274;138;136
17;Girona;203;Ultramort;225;117;108
17;Girona;206;Urús;196;96;100
17;Girona;014;Vajol, La;89;51;38
17;Girona;208;Vall de Bianya, La;1275;641;634
17;Girona;207;Vall d'en Bas, La;3093;1568;1525
17;Girona;170;Vallfogona de Ripollès;196;107;89
17;Girona;209;Vall-llobrega;897;451;446
17;Girona;210;Ventalló;846;428;418
17;Girona;211;Verges;1169;575;594
17;Girona;212;Vidrà;177;88;89
17;Girona;213;Vidreres;7951;4130;3821
17;Girona;214;Vilabertran;993;493;500
17;Girona;215;Vilablareix;3063;1517;1546
17;Girona;217;Viladamat;458;232;226
17;Girona;216;Viladasens;206;110;96
17;Girona;218;Vilademuls;835;431;404
17;Girona;220;Viladrau;1047;508;539
17;Girona;221;Vilafant;5421;2660;2761
17;Girona;223;Vilajuïga;1116;558;558
17;Girona;224;Vilallonga de Ter;398;213;185
17;Girona;225;Vilamacolum;377;211;166
17;Girona;226;Vilamalla;1161;586;575
17;Girona;227;Vilamaniscle;212;121;91
17;Girona;228;Vilanant;386;194;192
17;Girona;230;Vila-sacra;758;377;381
17;Girona;222;Vilaür;158;80;78
17;Girona;233;Vilobí d'Onyar;3333;1732;1601
17;Girona;232;Vilopriu;204;109;95
18;Granada;001;Agrón;260;131;129
18;Granada;002;Alamedilla;569;287;282
18;Granada;003;Albolote;18962;9371;9591
18;Granada;004;Albondón;712;392;320
18;Granada;005;Albuñán;409;211;198
18;Granada;006;Albuñol;7353;4050;3303
18;Granada;007;Albuñuelas;802;395;407
18;Granada;010;Aldeire;630;327;303
18;Granada;011;Alfacar;5488;2801;2687
18;Granada;012;Algarinejo;2467;1275;1192
18;Granada;013;Alhama de Granada;5867;3118;2749
18;Granada;014;Alhendín;9509;4818;4691
18;Granada;015;Alicún de Ortega;471;235;236
18;Granada;016;Almegíjar;337;164;173
18;Granada;017;Almuñécar;25927;12783;13144
18;Granada;904;Alpujarra de la Sierra;969;551;418
18;Granada;018;Alquife;580;289;291
18;Granada;020;Arenas del Rey;653;352;301
18;Granada;021;Armilla;24340;12019;12321
18;Granada;022;Atarfe;18960;9487;9473
18;Granada;023;Baza;20430;10137;10293
18;Granada;024;Beas de Granada;980;514;466
18;Granada;025;Beas de Guadix;329;166;163
18;Granada;027;Benalúa;3310;1639;1671
18;Granada;028;Benalúa de las Villas;1054;547;507
18;Granada;029;Benamaurel;2260;1132;1128
18;Granada;030;Bérchules;712;379;333
18;Granada;032;Bubión;298;156;142
18;Granada;033;Busquístar;279;144;135
18;Granada;034;Cacín;568;288;280
18;Granada;035;Cádiar;1465;782;683
18;Granada;036;Cájar;5205;2519;2686
18;Granada;114;Calahorra, La;668;346;322
18;Granada;037;Calicasas;638;317;321
18;Granada;038;Campotéjar;1229;635;594
18;Granada;039;Caniles;4021;2055;1966
18;Granada;040;Cáñar;377;208;169
18;Granada;042;Capileira;563;281;282
18;Granada;043;Carataunas;201;106;95
18;Granada;044;Cástaras;235;139;96
18;Granada;045;Castilléjar;1321;683;638
18;Granada;046;Castril;2020;1051;969
18;Granada;047;Cenes de la Vega;8153;4054;4099
18;Granada;059;Chauchina;5552;2747;2805
18;Granada;061;Chimeneas;1251;649;602
18;Granada;062;Churriana de la Vega;15689;7736;7953
18;Granada;048;Cijuela;3415;1758;1657
18;Granada;049;Cogollos de Guadix;642;358;284
18;Granada;050;Cogollos de la Vega;2007;1009;998
18;Granada;051;Colomera;1302;681;621
18;Granada;053;Cortes de Baza;1844;911;933
18;Granada;054;Cortes y Graena;982;513;469
18;Granada;912;Cuevas del Campo;1744;885;859
18;Granada;056;Cúllar;4091;2044;2047
18;Granada;057;Cúllar Vega;7547;3833;3714
18;Granada;063;Darro;1634;836;798
18;Granada;064;Dehesas de Guadix;422;206;216
18;Granada;065;Dehesas Viejas;688;357;331
18;Granada;066;Deifontes;2600;1318;1282
18;Granada;067;Diezma;764;406;358
18;Granada;068;Dílar;2092;1053;1039
18;Granada;069;Dólar;628;336;292
18;Granada;915;Domingo Pérez de Granada;878;454;424
18;Granada;070;Dúdar;327;172;155
18;Granada;071;Dúrcal;7111;3542;3569
18;Granada;072;Escúzar;791;410;381
18;Granada;074;Ferreira;301;156;145
18;Granada;076;Fonelas;978;508;470
18;Granada;077;Fornes;556;280;276
18;Granada;078;Freila;939;496;443
18;Granada;079;Fuente Vaqueros;4384;2195;2189
18;Granada;905;Gabias, Las;21543;10894;10649
18;Granada;082;Galera;1071;546;525
18;Granada;083;Gobernador;229;115;114
18;Granada;084;Gójar;5909;3013;2896
18;Granada;085;Gor;744;403;341
18;Granada;086;Gorafe;383;194;189
18;Granada;087;Granada;233648;107829;125819
18;Granada;088;Guadahortuna;1872;968;904
18;Granada;089;Guadix;18436;9175;9261
18;Granada;906;Guájares, Los;1053;569;484
18;Granada;093;Gualchos;5190;2792;2398
18;Granada;094;Güéjar Sierra;2857;1525;1332
18;Granada;095;Güevéjar;2640;1395;1245
18;Granada;096;Huélago;401;213;188
18;Granada;097;Huéneja;1170;627;543
18;Granada;098;Huéscar;7195;3568;3627
18;Granada;099;Huétor de Santillán;1882;969;913
18;Granada;100;Huétor Tájar;10399;5222;5177
18;Granada;101;Huétor Vega;12035;6030;6005
18;Granada;102;Íllora;10065;5063;5002
18;Granada;103;Ítrabo;991;488;503
18;Granada;105;Iznalloz;5120;2629;2491
18;Granada;106;Játar;623;343;280
18;Granada;107;Jayena;1052;544;508
18;Granada;108;Jérez del Marquesado;955;491;464
18;Granada;109;Jete;927;494;433
18;Granada;111;Jun;3853;1951;1902
18;Granada;112;Juviles;135;67;68
18;Granada;115;Láchar;3513;1788;1725
18;Granada;116;Lanjarón;3530;1768;1762
18;Granada;117;Lanteira;564;305;259
18;Granada;119;Lecrín;2156;1085;1071
18;Granada;120;Lentegí;333;171;162
18;Granada;121;Lobras;133;65;68
18;Granada;122;Loja;20419;10176;10243
18;Granada;123;Lugros;310;162;148
18;Granada;124;Lújar;483;258;225
18;Granada;126;Malahá, La;1784;899;885
18;Granada;127;Maracena;22306;10917;11389
18;Granada;128;Marchal;414;197;217
18;Granada;132;Moclín;3622;1794;1828
18;Granada;133;Molvízar;2772;1416;1356
18;Granada;134;Monachil;8007;4121;3886
18;Granada;135;Montefrío;5313;2722;2591
18;Granada;136;Montejícar;2110;1088;1022
18;Granada;137;Montillana;1129;595;534
18;Granada;138;Moraleda de Zafayona;3117;1576;1541
18;Granada;909;Morelábor;572;310;262
18;Granada;140;Motril;58460;28773;29687
18;Granada;141;Murtas;455;263;192
18;Granada;903;Nevada;1072;553;519
18;Granada;143;Nigüelas;1185;603;582
18;Granada;144;Nívar;1036;532;504
18;Granada;145;Ogíjares;14348;7117;7231
18;Granada;146;Orce;1185;598;587
18;Granada;147;Órgiva;5784;2900;2884
18;Granada;148;Otívar;1011;513;498
18;Granada;150;Padul;8694;4366;4328
18;Granada;151;Pampaneira;317;157;160
18;Granada;152;Pedro Martínez;1138;556;582
18;Granada;153;Peligros;11492;5692;5800
18;Granada;154;Peza, La;1167;596;571
18;Granada;910;Pinar, El;865;466;399
18;Granada;157;Pinos Genil;1490;775;715
18;Granada;158;Pinos Puente;9894;4966;4928
18;Granada;159;Píñar;1103;606;497
18;Granada;161;Polícar;263;142;121
18;Granada;162;Polopos;1722;959;763
18;Granada;163;Pórtugos;368;188;180
18;Granada;164;Puebla de Don Fadrique;2238;1139;1099
18;Granada;165;Pulianas;5466;2746;2720
18;Granada;167;Purullena;2306;1174;1132
18;Granada;168;Quéntar;947;487;460
18;Granada;170;Rubite;382;207;175
18;Granada;171;Salar;2621;1304;1317
18;Granada;173;Salobreña;12513;6248;6265
18;Granada;174;Santa Cruz del Comercio;531;272;259
18;Granada;175;Santa Fe;15222;7480;7742
18;Granada;176;Soportújar;264;141;123
18;Granada;177;Sorvilán;527;286;241
18;Granada;901;Taha, La;670;345;325
18;Granada;178;Torre-Cardela;716;385;331
18;Granada;916;Torrenueva Costa;2796;1446;1350
18;Granada;179;Torvizcón;625;332;293
18;Granada;180;Trevélez;736;389;347
18;Granada;181;Turón;232;136;96
18;Granada;182;Ugíjar;2517;1246;1271
18;Granada;914;Valderrubio;2066;1020;1046
18;Granada;907;Valle del Zalabí;2105;1074;1031
18;Granada;902;Valle, El;907;451;456
18;Granada;183;Válor;677;350;327
18;Granada;911;Vegas del Genil;11432;5839;5593
18;Granada;184;Vélez de Benaudalla;2890;1450;1440
18;Granada;185;Ventas de Huelma;657;360;297
18;Granada;149;Villa de Otura;6982;3512;3470
18;Granada;908;Villamena;934;481;453
18;Granada;187;Villanueva de las Torres;562;302;260
18;Granada;188;Villanueva Mesía;2021;995;1026
18;Granada;189;Víznar;993;514;479
18;Granada;192;Zafarraya;2120;1119;1001
18;Granada;913;Zagra;885;467;418
18;Granada;193;Zubia, La;19330;9582;9748
18;Granada;194;Zújar;2544;1282;1262
19;Guadalajara;001;Abánades;53;30;23
19;Guadalajara;002;Ablanque;55;30;25
19;Guadalajara;003;Adobes;35;20;15
19;Guadalajara;004;Alaminos;58;28;30
19;Guadalajara;005;Alarilla;137;87;50
19;Guadalajara;006;Albalate de Zorita;930;519;411
19;Guadalajara;007;Albares;513;268;245
19;Guadalajara;008;Albendiego;50;31;19
19;Guadalajara;009;Alcocer;328;168;160
19;Guadalajara;010;Alcolea de las Peñas;14;8;6
19;Guadalajara;011;Alcolea del Pinar;327;181;146
19;Guadalajara;013;Alcoroches;127;79;48
19;Guadalajara;015;Aldeanueva de Guadalajara;86;52;34
19;Guadalajara;016;Algar de Mesa;55;40;15
19;Guadalajara;017;Algora;66;42;24
19;Guadalajara;018;Alhóndiga;161;91;70
19;Guadalajara;019;Alique;14;7;7
19;Guadalajara;020;Almadrones;55;37;18
19;Guadalajara;021;Almoguera;1300;668;632
19;Guadalajara;022;Almonacid de Zorita;696;350;346
19;Guadalajara;023;Alocén;161;81;80
19;Guadalajara;024;Alovera;12860;6558;6302
19;Guadalajara;027;Alustante;155;90;65
19;Guadalajara;031;Angón;7;6;1
19;Guadalajara;032;Anguita;155;83;72
19;Guadalajara;033;Anquela del Ducado;46;27;19
19;Guadalajara;034;Anquela del Pedregal;29;17;12
19;Guadalajara;036;Aranzueque;358;194;164
19;Guadalajara;037;Arbancón;149;88;61
19;Guadalajara;038;Arbeteta;20;15;5
19;Guadalajara;039;Argecilla;59;41;18
19;Guadalajara;040;Armallones;54;30;24
19;Guadalajara;041;Armuña de Tajuña;229;122;107
19;Guadalajara;042;Arroyo de las Fraguas;21;11;10
19;Guadalajara;043;Atanzón;97;65;32
19;Guadalajara;044;Atienza;385;221;164
19;Guadalajara;045;Auñón;134;78;56
19;Guadalajara;046;Azuqueca de Henares;35407;17928;17479
19;Guadalajara;047;Baides;56;28;28
19;Guadalajara;048;Baños de Tajo;18;13;5
19;Guadalajara;049;Bañuelos;13;11;2
19;Guadalajara;050;Barriopedro;15;10;5
19;Guadalajara;051;Berninches;52;34;18
19;Guadalajara;052;Bodera, La;23;16;7
19;Guadalajara;053;Brihuega;2378;1246;1132
19;Guadalajara;054;Budia;189;115;74
19;Guadalajara;055;Bujalaro;50;24;26
19;Guadalajara;057;Bustares;74;45;29
19;Guadalajara;058;Cabanillas del Campo;10657;5370;5287
19;Guadalajara;059;Campillo de Dueñas;80;47;33
19;Guadalajara;060;Campillo de Ranas;171;100;71
19;Guadalajara;061;Campisábalos;60;46;14
19;Guadalajara;064;Canredondo;64;41;23
19;Guadalajara;065;Cantalojas;146;88;58
19;Guadalajara;066;Cañizar;53;32;21
19;Guadalajara;067;Cardoso de la Sierra, El;57;35;22
19;Guadalajara;070;Casa de Uceda;91;47;44
19;Guadalajara;071;Casar, El;12415;6291;6124
19;Guadalajara;073;Casas de San Galindo;19;14;5
19;Guadalajara;074;Caspueñas;96;59;37
19;Guadalajara;075;Castejón de Henares;64;40;24
19;Guadalajara;076;Castellar de la Muela;29;18;11
19;Guadalajara;078;Castilforte;52;35;17
19;Guadalajara;079;Castilnuevo;7;5;2
19;Guadalajara;080;Cendejas de Enmedio;68;35;33
19;Guadalajara;081;Cendejas de la Torre;25;17;8
19;Guadalajara;082;Centenera;121;67;54
19;Guadalajara;103;Checa;285;170;115
19;Guadalajara;104;Chequilla;18;9;9
19;Guadalajara;106;Chillarón del Rey;90;50;40
19;Guadalajara;105;Chiloeches;3623;1886;1737
19;Guadalajara;086;Cifuentes;1634;846;788
19;Guadalajara;087;Cincovillas;19;10;9
19;Guadalajara;088;Ciruelas;112;63;49
19;Guadalajara;089;Ciruelos del Pinar;19;13;6
19;Guadalajara;090;Cobeta;106;52;54
19;Guadalajara;091;Cogollor;24;15;9
19;Guadalajara;092;Cogolludo;519;305;214
19;Guadalajara;095;Condemios de Abajo;13;9;4
19;Guadalajara;096;Condemios de Arriba;111;65;46
19;Guadalajara;097;Congostrina;14;11;3
19;Guadalajara;098;Copernal;32;20;12
19;Guadalajara;099;Corduente;339;188;151
19;Guadalajara;102;Cubillo de Uceda, El;119;65;54
19;Guadalajara;107;Driebes;348;192;156
19;Guadalajara;108;Durón;99;55;44
19;Guadalajara;109;Embid;35;20;15
19;Guadalajara;110;Escamilla;56;35;21
19;Guadalajara;111;Escariche;178;110;68
19;Guadalajara;112;Escopete;52;25;27
19;Guadalajara;113;Espinosa de Henares;629;324;305
19;Guadalajara;114;Esplegares;32;19;13
19;Guadalajara;115;Establés;35;22;13
19;Guadalajara;116;Estriégana;14;9;5
19;Guadalajara;117;Fontanar;2406;1260;1146
19;Guadalajara;118;Fuembellida;12;8;4
19;Guadalajara;119;Fuencemillán;82;52;30
19;Guadalajara;120;Fuentelahiguera de Albatages;131;76;55
19;Guadalajara;121;Fuentelencina;312;173;139
19;Guadalajara;122;Fuentelsaz;89;49;40
19;Guadalajara;123;Fuentelviejo;47;28;19
19;Guadalajara;124;Fuentenovilla;513;284;229
19;Guadalajara;125;Gajanejos;54;33;21
19;Guadalajara;126;Galápagos;2475;1302;1173
19;Guadalajara;127;Galve de Sorbe;109;60;49
19;Guadalajara;129;Gascueña de Bornova;29;17;12
19;Guadalajara;130;Guadalajara;87484;42091;45393
19;Guadalajara;132;Henche;96;52;44
19;Guadalajara;133;Heras de Ayuso;255;149;106
19;Guadalajara;134;Herrería;24;12;12
19;Guadalajara;135;Hiendelaencina;109;68;41
19;Guadalajara;136;Hijes;18;9;9
19;Guadalajara;138;Hita;288;161;127
19;Guadalajara;139;Hombrados;35;23;12
19;Guadalajara;142;Hontoba;339;192;147
19;Guadalajara;143;Horche;2622;1322;1300
19;Guadalajara;145;Hortezuela de Océn;40;25;15
19;Guadalajara;146;Huerce, La;56;35;21
19;Guadalajara;147;Huérmeces del Cerro;41;28;13
19;Guadalajara;148;Huertahernando;54;35;19
19;Guadalajara;150;Hueva;120;75;45
19;Guadalajara;151;Humanes;1511;760;751
19;Guadalajara;152;Illana;664;368;296
19;Guadalajara;153;Iniéstola;23;15;8
19;Guadalajara;154;Inviernas, Las;58;39;19
19;Guadalajara;155;Irueste;72;46;26
19;Guadalajara;156;Jadraque;1370;726;644
19;Guadalajara;157;Jirueque;55;37;18
19;Guadalajara;159;Ledanca;104;52;52
19;Guadalajara;160;Loranca de Tajuña;1264;687;577
19;Guadalajara;161;Lupiana;259;136;123
19;Guadalajara;162;Luzaga;67;39;28
19;Guadalajara;163;Luzón;69;34;35
19;Guadalajara;165;Majaelrayo;55;32;23
19;Guadalajara;166;Málaga del Fresno;185;102;83
19;Guadalajara;167;Malaguilla;158;84;74
19;Guadalajara;168;Mandayona;287;140;147
19;Guadalajara;169;Mantiel;31;21;10
19;Guadalajara;170;Maranchón;234;124;110
19;Guadalajara;171;Marchamalo;7684;3849;3835
19;Guadalajara;172;Masegoso de Tajuña;49;27;22
19;Guadalajara;173;Matarrubia;57;38;19
19;Guadalajara;174;Matillas;101;56;45
19;Guadalajara;175;Mazarete;35;18;17
19;Guadalajara;176;Mazuecos;266;152;114
19;Guadalajara;177;Medranda;60;32;28
19;Guadalajara;178;Megina;29;17;12
19;Guadalajara;179;Membrillera;87;49;38
19;Guadalajara;181;Miedes de Atienza;53;35;18
19;Guadalajara;182;Mierla, La;39;26;13
19;Guadalajara;184;Millana;105;67;38
19;Guadalajara;183;Milmarcos;78;48;30
19;Guadalajara;185;Miñosa, La;26;17;9
19;Guadalajara;186;Mirabueno;74;47;27
19;Guadalajara;187;Miralrío;53;29;24
19;Guadalajara;188;Mochales;40;21;19
19;Guadalajara;189;Mohernando;183;95;88
19;Guadalajara;190;Molina de Aragón;3233;1597;1636
19;Guadalajara;191;Monasterio;14;6;8
19;Guadalajara;192;Mondéjar;2686;1382;1304
19;Guadalajara;193;Montarrón;25;15;10
19;Guadalajara;194;Moratilla de los Meleros;100;55;45
19;Guadalajara;195;Morenilla;37;22;15
19;Guadalajara;196;Muduex;100;53;47
19;Guadalajara;197;Navas de Jadraque, Las;32;22;10
19;Guadalajara;198;Negredo;17;9;8
19;Guadalajara;199;Ocentejo;18;13;5
19;Guadalajara;200;Olivar, El;69;38;31
19;Guadalajara;201;Olmeda de Cobeta;67;38;29
19;Guadalajara;202;Olmeda de Jadraque, La;15;8;7
19;Guadalajara;203;Ordial, El;28;16;12
19;Guadalajara;204;Orea;181;107;74
19;Guadalajara;208;Pálmaces de Jadraque;40;26;14
19;Guadalajara;209;Pardos;43;25;18
19;Guadalajara;210;Paredes de Sigüenza;22;10;12
19;Guadalajara;211;Pareja;393;234;159
19;Guadalajara;212;Pastrana;858;430;428
19;Guadalajara;213;Pedregal, El;72;45;27
19;Guadalajara;214;Peñalén;75;43;32
19;Guadalajara;215;Peñalver;133;87;46
19;Guadalajara;216;Peralejos de las Truchas;152;80;72
19;Guadalajara;217;Peralveche;38;28;10
19;Guadalajara;218;Pinilla de Jadraque;47;26;21
19;Guadalajara;219;Pinilla de Molina;9;7;2
19;Guadalajara;220;Pioz;4352;2275;2077
19;Guadalajara;221;Piqueras;52;35;17
19;Guadalajara;222;Pobo de Dueñas, El;108;57;51
19;Guadalajara;223;Poveda de la Sierra;114;59;55
19;Guadalajara;224;Pozo de Almoguera;107;64;43
19;Guadalajara;225;Pozo de Guadalajara;1332;713;619
19;Guadalajara;226;Prádena de Atienza;47;35;12
19;Guadalajara;227;Prados Redondos;60;42;18
19;Guadalajara;228;Puebla de Beleña;43;24;19
19;Guadalajara;229;Puebla de Valles;59;33;26
19;Guadalajara;230;Quer;830;433;397
19;Guadalajara;231;Rebollosa de Jadraque;10;7;3
19;Guadalajara;232;Recuenco, El;59;36;23
19;Guadalajara;233;Renera;100;59;41
19;Guadalajara;234;Retiendas;43;31;12
19;Guadalajara;235;Riba de Saelices;102;61;41
19;Guadalajara;237;Rillo de Gallo;42;26;16
19;Guadalajara;238;Riofrío del Llano;57;33;24
19;Guadalajara;239;Robledillo de Mohernando;117;61;56
19;Guadalajara;240;Robledo de Corpes;44;27;17
19;Guadalajara;241;Romanillos de Atienza;36;24;12
19;Guadalajara;242;Romanones;95;48;47
19;Guadalajara;243;Rueda de la Sierra;39;28;11
19;Guadalajara;244;Sacecorbo;89;51;38
19;Guadalajara;245;Sacedón;1523;793;730
19;Guadalajara;246;Saelices de la Sal;39;23;16
19;Guadalajara;247;Salmerón;140;81;59
19;Guadalajara;248;San Andrés del Congosto;74;47;27
19;Guadalajara;249;San Andrés del Rey;40;23;17
19;Guadalajara;250;Santiuste;14;9;5
19;Guadalajara;251;Saúca;56;33;23
19;Guadalajara;252;Sayatón;68;41;27
19;Guadalajara;254;Selas;44;22;22
19;Guadalajara;901;Semillas;35;20;15
19;Guadalajara;255;Setiles;80;43;37
19;Guadalajara;256;Sienes;52;31;21
19;Guadalajara;257;Sigüenza;4319;2184;2135
19;Guadalajara;258;Solanillos del Extremo;88;52;36
19;Guadalajara;259;Somolinos;29;16;13
19;Guadalajara;260;Sotillo, El;43;22;21
19;Guadalajara;261;Sotodosos;33;19;14
19;Guadalajara;262;Tamajón;137;74;63
19;Guadalajara;263;Taragudo;44;27;17
19;Guadalajara;264;Taravilla;36;25;11
19;Guadalajara;265;Tartanedo;144;85;59
19;Guadalajara;266;Tendilla;304;169;135
19;Guadalajara;267;Terzaga;22;12;10
19;Guadalajara;268;Tierzo;55;31;24
19;Guadalajara;269;Toba, La;85;54;31
19;Guadalajara;271;Tordellego;47;24;23
19;Guadalajara;270;Tordelrábano;11;8;3
19;Guadalajara;272;Tordesilos;85;50;35
19;Guadalajara;274;Torija;1527;793;734
19;Guadalajara;279;Torre del Burgo;611;341;270
19;Guadalajara;277;Torrecuadrada de Molina;18;13;5
19;Guadalajara;278;Torrecuadradilla;27;16;11
19;Guadalajara;280;Torrejón del Rey;5623;2938;2685
19;Guadalajara;281;Torremocha de Jadraque;21;11;10
19;Guadalajara;282;Torremocha del Campo;172;98;74
19;Guadalajara;283;Torremocha del Pinar;38;19;19
19;Guadalajara;284;Torremochuela;9;6;3
19;Guadalajara;285;Torrubia;20;12;8
19;Guadalajara;286;Tórtola de Henares;1165;632;533
19;Guadalajara;287;Tortuera;191;101;90
19;Guadalajara;288;Tortuero;16;12;4
19;Guadalajara;289;Traíd;25;17;8
19;Guadalajara;290;Trijueque;1226;660;566
19;Guadalajara;291;Trillo;1338;697;641
19;Guadalajara;293;Uceda;2715;1410;1305
19;Guadalajara;294;Ujados;30;16;14
19;Guadalajara;296;Utande;39;27;12
19;Guadalajara;297;Valdarachas;40;21;19
19;Guadalajara;298;Valdearenas;78;49;29
19;Guadalajara;299;Valdeavellano;105;56;49
19;Guadalajara;300;Valdeaveruelo;1084;571;513
19;Guadalajara;301;Valdeconcha;37;21;16
19;Guadalajara;302;Valdegrudas;55;34;21
19;Guadalajara;303;Valdelcubo;42;28;14
19;Guadalajara;304;Valdenuño Fernández;269;142;127
19;Guadalajara;305;Valdepeñas de la Sierra;149;85;64
19;Guadalajara;306;Valderrebollo;23;12;11
19;Guadalajara;307;Valdesotos;22;14;8
19;Guadalajara;308;Valfermoso de Tajuña;64;45;19
19;Guadalajara;309;Valhermoso;22;12;10
19;Guadalajara;310;Valtablado del Río;7;4;3
19;Guadalajara;311;Valverde de los Arroyos;93;50;43
19;Guadalajara;314;Viana de Jadraque;44;30;14
19;Guadalajara;317;Villanueva de Alcorón;148;82;66
19;Guadalajara;318;Villanueva de Argecilla;37;21;16
19;Guadalajara;319;Villanueva de la Torre;6631;3347;3284
19;Guadalajara;321;Villares de Jadraque;43;28;15
19;Guadalajara;322;Villaseca de Henares;25;12;13
19;Guadalajara;323;Villaseca de Uceda;39;20;19
19;Guadalajara;324;Villel de Mesa;178;104;74
19;Guadalajara;325;Viñuelas;162;84;78
19;Guadalajara;326;Yebes;4189;2188;2001
19;Guadalajara;327;Yebra;453;246;207
19;Guadalajara;329;Yélamos de Abajo;63;33;30
19;Guadalajara;330;Yélamos de Arriba;74;44;30
19;Guadalajara;331;Yunquera de Henares;4205;2155;2050
19;Guadalajara;332;Yunta, La;90;53;37
19;Guadalajara;333;Zaorejas;104;72;32
19;Guadalajara;334;Zarzuela de Jadraque;42;27;15
19;Guadalajara;335;Zorita de los Canes;70;36;34
21;Huelva;001;Alájar;759;393;366
21;Huelva;002;Aljaraque;21474;10683;10791
21;Huelva;003;Almendro, El;840;440;400
21;Huelva;004;Almonaster la Real;1788;960;828
21;Huelva;005;Almonte;24507;11817;12690
21;Huelva;006;Alosno;3933;1936;1997
21;Huelva;007;Aracena;8255;4059;4196
21;Huelva;008;Aroche;3054;1522;1532
21;Huelva;009;Arroyomolinos de León;947;484;463
21;Huelva;010;Ayamonte;21104;10574;10530
21;Huelva;011;Beas;4341;2178;2163
21;Huelva;012;Berrocal;303;149;154
21;Huelva;013;Bollullos Par del Condado;14387;7150;7237
21;Huelva;014;Bonares;6060;3027;3033
21;Huelva;015;Cabezas Rubias;706;371;335
21;Huelva;016;Cala;1159;586;573
21;Huelva;017;Calañas;2768;1419;1349
21;Huelva;018;Campillo, El;2024;979;1045
21;Huelva;019;Campofrío;713;361;352
21;Huelva;020;Cañaveral de León;396;198;198
21;Huelva;021;Cartaya;20083;10238;9845
21;Huelva;022;Castaño del Robledo;228;122;106
21;Huelva;023;Cerro de Andévalo, El;2327;1153;1174
21;Huelva;030;Chucena;2223;1118;1105
21;Huelva;024;Corteconcepción;536;281;255
21;Huelva;025;Cortegana;4602;2333;2269
21;Huelva;026;Cortelazor;299;142;157
21;Huelva;027;Cumbres de Enmedio;51;31;20
21;Huelva;028;Cumbres de San Bartolomé;376;186;190
21;Huelva;029;Cumbres Mayores;1749;868;881
21;Huelva;031;Encinasola;1310;665;645
21;Huelva;032;Escacena del Campo;2287;1112;1175
21;Huelva;033;Fuenteheridos;709;359;350
21;Huelva;034;Galaroza;1382;684;698
21;Huelva;035;Gibraleón;12737;6342;6395
21;Huelva;036;Granada de Río-Tinto, La;243;122;121
21;Huelva;037;Granado, El;532;283;249
21;Huelva;038;Higuera de la Sierra;1291;673;618
21;Huelva;039;Hinojales;330;167;163
21;Huelva;040;Hinojos;3961;1993;1968
21;Huelva;041;Huelva;143837;69043;74794
21;Huelva;042;Isla Cristina;21393;10686;10707
21;Huelva;043;Jabugo;2260;1139;1121
21;Huelva;044;Lepe;27880;14302;13578
21;Huelva;045;Linares de la Sierra;262;126;136
21;Huelva;046;Lucena del Puerto;3261;1710;1551
21;Huelva;047;Manzanilla;2118;1080;1038
21;Huelva;048;Marines, Los;399;217;182
21;Huelva;049;Minas de Riotinto;3812;1854;1958
21;Huelva;050;Moguer;21867;10926;10941
21;Huelva;051;Nava, La;258;132;126
21;Huelva;052;Nerva;5169;2476;2693
21;Huelva;053;Niebla;4116;2071;2045
21;Huelva;054;Palma del Condado, La;10801;5404;5397
21;Huelva;055;Palos de la Frontera;11742;5971;5771
21;Huelva;056;Paterna del Campo;3457;1760;1697
21;Huelva;057;Paymogo;1162;577;585
21;Huelva;058;Puebla de Guzmán;3092;1586;1506
21;Huelva;059;Puerto Moral;278;132;146
21;Huelva;060;Punta Umbría;15355;7805;7550
21;Huelva;061;Rociana del Condado;7939;3968;3971
21;Huelva;062;Rosal de la Frontera;1697;838;859
21;Huelva;063;San Bartolomé de la Torre;3761;1871;1890
21;Huelva;064;San Juan del Puerto;9411;4728;4683
21;Huelva;066;San Silvestre de Guzmán;614;322;292
21;Huelva;065;Sanlúcar de Guadiana;403;199;204
21;Huelva;067;Santa Ana la Real;475;220;255
21;Huelva;068;Santa Bárbara de Casa;1043;517;526
21;Huelva;069;Santa Olalla del Cala;2022;1037;985
21;Huelva;070;Trigueros;7862;3905;3957
21;Huelva;071;Valdelarco;231;108;123
21;Huelva;072;Valverde del Camino;12750;6267;6483
21;Huelva;073;Villablanca;2885;1410;1475
21;Huelva;074;Villalba del Alcor;3366;1663;1703
21;Huelva;075;Villanueva de las Cruces;387;181;206
21;Huelva;076;Villanueva de los Castillejos;2825;1414;1411
21;Huelva;077;Villarrasa;2211;1114;1097
21;Huelva;078;Zalamea la Real;3054;1532;1522
21;Huelva;902;Zarza-Perrunal, La;1253;634;619
21;Huelva;079;Zufre;796;413;383
22;Huesca;001;Abiego;258;135;123
22;Huesca;002;Abizanda;139;70;69
22;Huesca;003;Adahuesca;180;98;82
22;Huesca;004;Agüero;125;71;54
22;Huesca;907;Aínsa-Sobrarbe;2242;1128;1114
22;Huesca;006;Aisa;313;171;142
22;Huesca;007;Albalate de Cinca;1099;595;504
22;Huesca;008;Albalatillo;163;86;77
22;Huesca;009;Albelda;708;374;334
22;Huesca;011;Albero Alto;120;67;53
22;Huesca;012;Albero Bajo;132;70;62
22;Huesca;013;Alberuela de Tubo;290;145;145
22;Huesca;014;Alcalá de Gurrea;239;127;112
22;Huesca;015;Alcalá del Obispo;298;164;134
22;Huesca;016;Alcampell;623;300;323
22;Huesca;017;Alcolea de Cinca;1177;641;536
22;Huesca;018;Alcubierre;362;198;164
22;Huesca;019;Alerre;200;103;97
22;Huesca;020;Alfántega;130;65;65
22;Huesca;021;Almudévar;2377;1197;1180
22;Huesca;022;Almunia de San Juan;666;340;326
22;Huesca;023;Almuniente;457;237;220
22;Huesca;024;Alquézar;312;161;151
22;Huesca;025;Altorricón;1420;771;649
22;Huesca;027;Angüés;353;188;165
22;Huesca;028;Ansó;386;194;192
22;Huesca;029;Antillón;135;70;65
22;Huesca;032;Aragüés del Puerto;111;60;51
22;Huesca;035;Arén;308;171;137
22;Huesca;036;Argavieso;95;57;38
22;Huesca;037;Arguis;125;71;54
22;Huesca;039;Ayerbe;1017;507;510
22;Huesca;040;Azanuy-Alins;170;82;88
22;Huesca;041;Azara;157;83;74
22;Huesca;042;Azlor;138;65;73
22;Huesca;043;Baélls;97;55;42
22;Huesca;044;Bailo;261;154;107
22;Huesca;045;Baldellou;64;38;26
22;Huesca;046;Ballobar;833;434;399
22;Huesca;047;Banastás;310;158;152
22;Huesca;048;Barbastro;17174;8364;8810
22;Huesca;049;Barbués;86;50;36
22;Huesca;050;Barbuñales;96;47;49
22;Huesca;051;Bárcabo;102;55;47
22;Huesca;052;Belver de Cinca;1301;762;539
22;Huesca;053;Benabarre;1142;596;546
22;Huesca;054;Benasque;2184;1179;1005
22;Huesca;246;Beranuy;75;45;30
22;Huesca;055;Berbegal;327;173;154
22;Huesca;057;Bielsa;448;235;213
22;Huesca;058;Bierge;252;139;113
22;Huesca;059;Biescas;1474;776;698
22;Huesca;060;Binaced;1605;878;727
22;Huesca;061;Binéfar;9742;5121;4621
22;Huesca;062;Bisaurri;171;91;80
22;Huesca;063;Biscarrués;182;97;85
22;Huesca;064;Blecua y Torres;173;99;74
22;Huesca;066;Boltaña;1045;560;485
22;Huesca;067;Bonansa;87;49;38
22;Huesca;068;Borau;70;38;32
22;Huesca;069;Broto;538;299;239
22;Huesca;072;Caldearenas;226;130;96
22;Huesca;074;Campo;436;229;207
22;Huesca;075;Camporrélls;127;66;61
22;Huesca;076;Canal de Berdún;323;176;147
22;Huesca;077;Candasnos;419;227;192
22;Huesca;078;Canfranc;558;311;247
22;Huesca;079;Capdesaso;211;88;123
22;Huesca;080;Capella;360;187;173
22;Huesca;081;Casbas de Huesca;275;152;123
22;Huesca;083;Castejón de Monegros;510;276;234
22;Huesca;084;Castejón de Sos;764;381;383
22;Huesca;082;Castejón del Puente;312;163;149
22;Huesca;085;Castelflorite;103;53;50
22;Huesca;086;Castiello de Jaca;221;126;95
22;Huesca;087;Castigaleu;79;49;30
22;Huesca;088;Castillazuelo;153;76;77
22;Huesca;089;Castillonroy;318;163;155
22;Huesca;094;Chalamera;113;60;53
22;Huesca;095;Chía;83;53;30
22;Huesca;096;Chimillas;402;200;202
22;Huesca;090;Colungo;117;65;52
22;Huesca;099;Esplús;632;324;308
22;Huesca;102;Estada;199;116;83
22;Huesca;103;Estadilla;796;391;405
22;Huesca;105;Estopiñán del Castillo;121;61;60
22;Huesca;106;Fago;20;12;8
22;Huesca;107;Fanlo;100;64;36
22;Huesca;109;Fiscal;331;181;150
22;Huesca;110;Fonz;851;432;419
22;Huesca;111;Foradada del Toscar;162;92;70
22;Huesca;112;Fraga;15353;7854;7499
22;Huesca;113;Fueva, La;600;321;279
22;Huesca;114;Gistaín;147;81;66
22;Huesca;115;Grado, El;395;208;187
22;Huesca;116;Grañén;1738;905;833
22;Huesca;117;Graus;3365;1658;1707
22;Huesca;119;Gurrea de Gállego;1476;744;732
22;Huesca;122;Hoz de Jaca;73;37;36
22;Huesca;908;Hoz y Costean;221;128;93
22;Huesca;124;Huerto;213;117;96
22;Huesca;125;Huesca;53956;25702;28254
22;Huesca;126;Ibieca;100;57;43
22;Huesca;127;Igriés;695;371;324
22;Huesca;128;Ilche;197;96;101
22;Huesca;129;Isábena;231;115;116
22;Huesca;130;Jaca;13129;6408;6721
22;Huesca;131;Jasa;96;56;40
22;Huesca;133;Labuerda;155;82;73
22;Huesca;135;Laluenga;191;100;91
22;Huesca;136;Lalueza;892;464;428
22;Huesca;137;Lanaja;1163;609;554
22;Huesca;139;Laperdiguera;92;47;45
22;Huesca;141;Lascellas-Ponzano;130;82;48
22;Huesca;142;Lascuarre;139;72;67
22;Huesca;143;Laspaúles;205;114;91
22;Huesca;144;Laspuña;297;162;135
22;Huesca;149;Loarre;323;179;144
22;Huesca;150;Loporzano;514;293;221
22;Huesca;151;Loscorrales;93;48;45
22;Huesca;905;Lupiñén-Ortilla;335;170;165
22;Huesca;155;Monesma y Cajigar;72;40;32
22;Huesca;156;Monflorite-Lascasas;405;213;192
22;Huesca;157;Montanuy;210;123;87
22;Huesca;158;Monzón;17469;8842;8627
22;Huesca;160;Naval;265;139;126
22;Huesca;162;Novales;152;76;76
22;Huesca;163;Nueno;546;301;245
22;Huesca;164;Olvena;56;29;27
22;Huesca;165;Ontiñena;508;255;253
22;Huesca;167;Osso de Cinca;678;379;299
22;Huesca;168;Palo;26;13;13
22;Huesca;170;Panticosa;800;417;383
22;Huesca;172;Peñalba;644;340;304
22;Huesca;173;Peñas de Riglos, Las;247;155;92
22;Huesca;174;Peralta de Alcofea;563;291;272
22;Huesca;175;Peralta de Calasanz;210;117;93
22;Huesca;176;Peraltilla;209;102;107
22;Huesca;177;Perarrúa;106;56;50
22;Huesca;178;Pertusa;120;73;47
22;Huesca;181;Piracés;100;51;49
22;Huesca;182;Plan;273;139;134
22;Huesca;184;Poleñino;210;110;100
22;Huesca;186;Pozán de Vero;214;105;109
22;Huesca;187;Puebla de Castro, La;377;194;183
22;Huesca;188;Puente de Montañana;93;42;51
22;Huesca;902;Puente la Reina de Jaca;245;127;118
22;Huesca;189;Puértolas;213;116;97
22;Huesca;190;Pueyo de Araguás, El;161;91;70
22;Huesca;193;Pueyo de Santa Cruz;331;168;163
22;Huesca;195;Quicena;282;137;145
22;Huesca;197;Robres;514;266;248
22;Huesca;199;Sabiñánigo;9185;4587;4598
22;Huesca;200;Sahún;303;155;148
22;Huesca;201;Salas Altas;306;156;150
22;Huesca;202;Salas Bajas;185;88;97
22;Huesca;203;Salillas;91;51;40
22;Huesca;204;Sallent de Gállego;1477;729;748
22;Huesca;205;San Esteban de Litera;547;288;259
22;Huesca;207;San Juan de Plan;150;83;67
22;Huesca;903;San Miguel del Cinca;780;399;381
22;Huesca;206;Sangarrén;221;117;104
22;Huesca;208;Santa Cilia;243;124;119
22;Huesca;209;Santa Cruz de la Serós;188;109;79
22;Huesca;906;Santa María de Dulcis;205;107;98
22;Huesca;212;Santaliestra y San Quílez;80;41;39
22;Huesca;213;Sariñena;4184;2192;1992
22;Huesca;214;Secastilla;140;62;78
22;Huesca;215;Seira;145;84;61
22;Huesca;217;Sena;501;268;233
22;Huesca;218;Senés de Alcubierre;40;21;19
22;Huesca;220;Sesa;154;87;67
22;Huesca;221;Sesué;122;61;61
22;Huesca;222;Siétamo;689;378;311
22;Huesca;223;Sopeira;91;51;40
22;Huesca;904;Sotonera, La;859;460;399
22;Huesca;225;Tamarite de Litera;3487;1798;1689
22;Huesca;226;Tardienta;948;469;479
22;Huesca;227;Tella-Sin;225;129;96
22;Huesca;228;Tierz;781;392;389
22;Huesca;229;Tolva;122;68;54
22;Huesca;230;Torla-Ordesa;298;157;141
22;Huesca;232;Torralba de Aragón;113;66;47
22;Huesca;233;Torre la Ribera;96;51;45
22;Huesca;234;Torrente de Cinca;1327;715;612
22;Huesca;235;Torres de Alcanadre;82;49;33
22;Huesca;236;Torres de Barbués;251;123;128
22;Huesca;239;Tramaced;98;63;35
22;Huesca;242;Valfarta;63;39;24
22;Huesca;243;Valle de Bardají;40;22;18
22;Huesca;901;Valle de Hecho;817;432;385
22;Huesca;244;Valle de Lierp;51;30;21
22;Huesca;245;Velilla de Cinca;460;241;219
22;Huesca;909;Vencillón;390;209;181
22;Huesca;247;Viacamp y Litera;37;24;13
22;Huesca;248;Vicién;110;63;47
22;Huesca;249;Villanova;174;87;87
22;Huesca;250;Villanúa;451;238;213
22;Huesca;251;Villanueva de Sigena;384;202;182
22;Huesca;252;Yebra de Basa;142;86;56
22;Huesca;253;Yésero;57;33;24
22;Huesca;254;Zaidín;1798;950;848
23;Jaén;001;Albanchez de Mágina;1011;528;483
23;Jaén;002;Alcalá la Real;21709;10678;11031
23;Jaén;003;Alcaudete;10483;5173;5310
23;Jaén;004;Aldeaquemada;476;259;217
23;Jaén;005;Andújar;36615;17919;18696
23;Jaén;006;Arjona;5515;2715;2800
23;Jaén;007;Arjonilla;3571;1810;1761
23;Jaén;008;Arquillos;1722;866;856
23;Jaén;905;Arroyo del Ojanco;2287;1147;1140
23;Jaén;009;Baeza;15791;7817;7974
23;Jaén;010;Bailén;17548;8709;8839
23;Jaén;011;Baños de la Encina;2576;1329;1247
23;Jaén;012;Beas de Segura;5100;2658;2442
23;Jaén;902;Bedmar y Garcíez;2633;1334;1299
23;Jaén;014;Begíjar;3009;1509;1500
23;Jaén;015;Bélmez de la Moraleda;1569;790;779
23;Jaén;016;Benatae;445;227;218
23;Jaén;017;Cabra del Santo Cristo;1782;927;855
23;Jaén;018;Cambil;2683;1403;1280
23;Jaén;019;Campillo de Arenas;1751;887;864
23;Jaén;020;Canena;1814;936;878
23;Jaén;021;Carboneros;591;307;284
23;Jaén;901;Cárcheles;1332;700;632
23;Jaén;024;Carolina, La;15160;7497;7663
23;Jaén;025;Castellar;3292;1659;1633
23;Jaén;026;Castillo de Locubín;4049;1998;2051
23;Jaén;027;Cazalilla;803;396;407
23;Jaén;028;Cazorla;7352;3565;3787
23;Jaén;029;Chiclana de Segura;955;482;473
23;Jaén;030;Chilluévar;1410;682;728
23;Jaén;031;Escañuela;944;463;481
23;Jaén;032;Espeluy;620;304;316
23;Jaén;033;Frailes;1585;788;797
23;Jaén;034;Fuensanta de Martos;3038;1524;1514
23;Jaén;035;Fuerte del Rey;1355;688;667
23;Jaén;037;Génave;590;324;266
23;Jaén;038;Guardia de Jaén, La;4983;2518;2465
23;Jaén;039;Guarromán;2739;1384;1355
23;Jaén;041;Higuera de Calatrava;614;325;289
23;Jaén;042;Hinojares;373;199;174
23;Jaén;043;Hornos;594;295;299
23;Jaén;044;Huelma;5744;2857;2887
23;Jaén;045;Huesa;2490;1262;1228
23;Jaén;046;Ibros;2827;1422;1405
23;Jaén;047;Iruela, La;1879;938;941
23;Jaén;048;Iznatoraf;942;478;464
23;Jaén;049;Jabalquinto;2017;1022;995
23;Jaén;050;Jaén;112757;54244;58513
23;Jaén;051;Jamilena;3271;1654;1617
23;Jaén;052;Jimena;1269;612;657
23;Jaén;053;Jódar;11634;5813;5821
23;Jaén;040;Lahiguera;1686;827;859
23;Jaén;054;Larva;474;244;230
23;Jaén;055;Linares;57353;28042;29311
23;Jaén;056;Lopera;3652;1854;1798
23;Jaén;057;Lupión;820;405;415
23;Jaén;058;Mancha Real;11328;5660;5668
23;Jaén;059;Marmolejo;6763;3354;3409
23;Jaén;060;Martos;24343;12070;12273
23;Jaén;061;Mengíbar;9997;4973;5024
23;Jaén;062;Montizón;1689;866;823
23;Jaén;063;Navas de San Juan;4528;2275;2253
23;Jaén;064;Noalejo;1932;978;954
23;Jaén;065;Orcera;1791;912;879
23;Jaén;066;Peal de Becerro;5240;2605;2635
23;Jaén;067;Pegalajar;2875;1453;1422
23;Jaén;069;Porcuna;6156;3102;3054
23;Jaén;070;Pozo Alcón;4731;2436;2295
23;Jaén;071;Puente de Génave;2159;1076;1083
23;Jaén;072;Puerta de Segura, La;2234;1121;1113
23;Jaén;073;Quesada;5196;2638;2558
23;Jaén;074;Rus;3531;1811;1720
23;Jaén;075;Sabiote;3886;1918;1968
23;Jaén;076;Santa Elena;890;465;425
23;Jaén;077;Santiago de Calatrava;675;360;315
23;Jaén;904;Santiago-Pontones;2911;1491;1420
23;Jaén;079;Santisteban del Puerto;4463;2297;2166
23;Jaén;080;Santo Tomé;2129;1091;1038
23;Jaén;081;Segura de la Sierra;1803;885;918
23;Jaén;082;Siles;2220;1126;1094
23;Jaén;084;Sorihuela del Guadalimar;1098;571;527
23;Jaén;085;Torreblascopedro;2508;1271;1237
23;Jaén;086;Torredelcampo;14142;7079;7063
23;Jaén;087;Torredonjimeno;13632;6710;6922
23;Jaén;088;Torreperogil;7222;3532;3690
23;Jaén;090;Torres;1372;709;663
23;Jaén;091;Torres de Albánchez;770;402;368
23;Jaén;092;Úbeda;34329;16790;17539
23;Jaén;093;Valdepeñas de Jaén;3679;1819;1860
23;Jaén;094;Vilches;4409;2210;2199
23;Jaén;095;Villacarrillo;10673;5363;5310
23;Jaén;096;Villanueva de la Reina;3038;1522;1516
23;Jaén;097;Villanueva del Arzobispo;8078;4143;3935
23;Jaén;098;Villardompardo;968;488;480
23;Jaén;099;Villares, Los;6020;3014;3006
23;Jaén;101;Villarrodrigo;391;210;181
23;Jaén;903;Villatorres;4298;2175;2123
24;León;001;Acebedo;184;108;76
24;León;002;Algadefe;278;143;135
24;León;003;Alija del Infantado;629;323;306
24;León;004;Almanza;581;335;246
24;León;005;Antigua, La;358;207;151
24;León;006;Ardón;560;302;258
24;León;007;Arganza;774;391;383
24;León;008;Astorga;10741;5027;5714
24;León;009;Balboa;292;159;133
24;León;010;Bañeza, La;10290;4949;5341
24;León;011;Barjas;172;94;78
24;León;012;Barrios de Luna, Los;307;177;130
24;León;014;Bembibre;8598;4145;4453
24;León;015;Benavides;2440;1209;1231
24;León;016;Benuza;482;287;195
24;León;017;Bercianos del Páramo;554;280;274
24;León;018;Bercianos del Real Camino;185;100;85
24;León;019;Berlanga del Bierzo;354;163;191
24;León;020;Boca de Huérgano;455;274;181
24;León;021;Boñar;1816;916;900
24;León;022;Borrenes;309;166;143
24;León;023;Brazuelo;337;182;155
24;León;024;Burgo Ranero, El;702;370;332
24;León;025;Burón;303;176;127
24;León;026;Bustillo del Páramo;1129;585;544
24;León;027;Cabañas Raras;1335;685;650
24;León;028;Cabreros del Río;417;228;189
24;León;029;Cabrillanes;747;394;353
24;León;030;Cacabelos;4996;2470;2526
24;León;031;Calzada del Coto;218;131;87
24;León;032;Campazas;111;53;58
24;León;033;Campo de Villavidel;212;116;96
24;León;034;Camponaraya;4097;2014;2083
24;León;036;Candín;249;139;110
24;León;037;Cármenes;344;191;153
24;León;038;Carracedelo;3364;1684;1680
24;León;039;Carrizo;2224;1118;1106
24;León;040;Carrocera;446;242;204
24;León;041;Carucedo;531;266;265
24;León;042;Castilfalé;67;39;28
24;León;043;Castrillo de Cabrera;111;66;45
24;León;044;Castrillo de la Valduerna;155;68;87
24;León;046;Castrocalbón;938;489;449
24;León;047;Castrocontrigo;725;392;333
24;León;049;Castropodame;1629;841;788
24;León;050;Castrotierra de Valmadrigal;114;60;54
24;León;051;Cea;403;215;188
24;León;052;Cebanico;148;90;58
24;León;053;Cebrones del Río;439;244;195
24;León;065;Chozas de Abajo;2561;1323;1238
24;León;054;Cimanes de la Vega;449;232;217
24;León;055;Cimanes del Tejar;719;391;328
24;León;056;Cistierna;3090;1529;1561
24;León;057;Congosto;1446;725;721
24;León;058;Corbillos de los Oteros;185;106;79
24;León;059;Corullón;887;452;435
24;León;060;Crémenes;527;288;239
24;León;061;Cuadros;2035;1028;1007
24;León;062;Cubillas de los Oteros;135;77;58
24;León;063;Cubillas de Rueda;409;221;188
24;León;064;Cubillos del Sil;1768;929;839
24;León;066;Destriana;459;212;247
24;León;067;Encinedo;690;363;327
24;León;068;Ercina, La;441;235;206
24;León;069;Escobar de Campos;34;19;15
24;León;070;Fabero;4386;2138;2248
24;León;071;Folgoso de la Ribera;1045;507;538
24;León;073;Fresno de la Vega;479;247;232
24;León;074;Fuentes de Carbajal;93;53;40
24;León;076;Garrafe de Torío;1513;811;702
24;León;077;Gordaliza del Pino;245;120;125
24;León;078;Gordoncillo;365;181;184
24;León;079;Gradefes;931;513;418
24;León;080;Grajal de Campos;227;113;114
24;León;081;Gusendos de los Oteros;126;67;59
24;León;082;Hospital de Órbigo;991;500;491
24;León;083;Igüeña;1123;590;533
24;León;084;Izagre;161;82;79
24;León;086;Joarilla de las Matas;279;145;134
24;León;087;Laguna Dalga;640;343;297
24;León;088;Laguna de Negrillos;1061;545;516
24;León;089;León;124028;56191;67837
24;León;092;Llamas de la Ribera;800;423;377
24;León;090;Lucillo;367;198;169
24;León;091;Luyego;590;316;274
24;León;093;Magaz de Cepeda;367;196;171
24;León;094;Mansilla de las Mulas;1743;877;866
24;León;095;Mansilla Mayor;337;180;157
24;León;096;Maraña;112;69;43
24;León;097;Matadeón de los Oteros;223;112;111
24;León;098;Matallana de Torío;1270;661;609
24;León;099;Matanza;161;87;74
24;León;100;Molinaseca;862;477;385
24;León;101;Murias de Paredes;371;190;181
24;León;102;Noceda del Bierzo;640;330;310
24;León;103;Oencia;270;159;111
24;León;104;Omañas, Las;267;146;121
24;León;105;Onzonilla;1832;941;891
24;León;106;Oseja de Sajambre;224;133;91
24;León;107;Pajares de los Oteros;248;153;95
24;León;108;Palacios de la Valduerna;383;184;199
24;León;109;Palacios del Sil;907;498;409
24;León;110;Páramo del Sil;1255;644;611
24;León;112;Peranzanes;279;163;116
24;León;113;Pobladura de Pelayo García;379;198;181
24;León;114;Pola de Gordón, La;3120;1579;1541
24;León;115;Ponferrada;64509;30532;33977
24;León;116;Posada de Valdeón;415;239;176
24;León;117;Pozuelo del Páramo;423;210;213
24;León;118;Prado de la Guzpeña;104;59;45
24;León;119;Priaranza del Bierzo;773;388;385
24;León;120;Prioro;332;200;132
24;León;121;Puebla de Lillo;652;384;268
24;León;122;Puente de Domingo Flórez;1458;762;696
24;León;123;Quintana del Castillo;721;411;310
24;León;124;Quintana del Marco;353;190;163
24;León;125;Quintana y Congosto;375;193;182
24;León;127;Regueras de Arriba;277;146;131
24;León;129;Reyero;123;64;59
24;León;130;Riaño;458;252;206
24;León;131;Riego de la Vega;743;396;347
24;León;132;Riello;622;355;267
24;León;133;Rioseco de Tapia;381;216;165
24;León;134;Robla, La;3752;1862;1890
24;León;136;Roperuelos del Páramo;522;265;257
24;León;137;Sabero;1123;579;544
24;León;139;Sahagún;2477;1220;1257
24;León;141;San Adrián del Valle;100;54;46
24;León;142;San Andrés del Rabanedo;30549;14550;15999
24;León;144;San Cristóbal de la Polantera;667;347;320
24;León;145;San Emiliano;627;350;277
24;León;146;San Esteban de Nogales;257;136;121
24;León;148;San Justo de la Vega;1807;933;874
24;León;149;San Millán de los Caballeros;168;89;79
24;León;150;San Pedro Bercianos;231;123;108
24;León;143;Sancedo;546;272;274
24;León;151;Santa Colomba de Curueño;473;250;223
24;León;152;Santa Colomba de Somoza;501;272;229
24;León;153;Santa Cristina de Valmadrigal;254;134;120
24;León;154;Santa Elena de Jamuz;1047;549;498
24;León;155;Santa María de la Isla;476;246;230
24;León;158;Santa María de Ordás;315;168;147
24;León;156;Santa María del Monte de Cea;225;123;102
24;León;157;Santa María del Páramo;3101;1514;1587
24;León;159;Santa Marina del Rey;1860;934;926
24;León;160;Santas Martas;729;389;340
24;León;161;Santiago Millas;330;182;148
24;León;162;Santovenia de la Valdoncina;2100;1075;1025
24;León;163;Sariegos;5084;2545;2539
24;León;164;Sena de Luna;366;182;184
24;León;165;Sobrado;301;150;151
24;León;166;Soto de la Vega;1526;794;732
24;León;167;Soto y Amío;773;403;370
24;León;168;Toral de los Guzmanes;501;271;230
24;León;206;Toral de los Vados;1812;892;920
24;León;169;Toreno;3012;1498;1514
24;León;170;Torre del Bierzo;2114;1089;1025
24;León;171;Trabadelo;333;185;148
24;León;172;Truchas;419;222;197
24;León;173;Turcia;986;510;476
24;León;174;Urdiales del Páramo;494;264;230
24;León;185;Val de San Lorenzo;496;249;247
24;León;175;Valdefresno;2173;1132;1041
24;León;176;Valdefuentes del Páramo;319;172;147
24;León;177;Valdelugueros;515;295;220
24;León;178;Valdemora;73;32;41
24;León;179;Valdepiélago;307;177;130
24;León;180;Valdepolo;1200;650;550
24;León;181;Valderas;1586;798;788
24;León;182;Valderrey;446;229;217
24;León;183;Valderrueda;827;431;396
24;León;184;Valdesamario;189;104;85
24;León;187;Valdevimbre;958;497;461
24;León;188;Valencia de Don Juan;5272;2590;2682
24;León;191;Vallecillo;125;74;51
24;León;189;Valverde de la Virgen;7377;3811;3566
24;León;190;Valverde-Enrique;155;77;78
24;León;193;Vecilla, La;393;207;186
24;León;196;Vega de Espinareda;2044;1037;1007
24;León;197;Vega de Infanzones;818;413;405
24;León;198;Vega de Valcarce;587;304;283
24;León;194;Vegacervera;267;140;127
24;León;199;Vegaquemada;438;245;193
24;León;201;Vegas del Condado;1109;643;466
24;León;202;Villablino;8444;4148;4296
24;León;203;Villabraz;91;51;40
24;León;205;Villadangos del Páramo;1163;611;552
24;León;207;Villademor de la Vega;325;174;151
24;León;209;Villafranca del Bierzo;2855;1381;1474
24;León;210;Villagatón;627;335;292
24;León;211;Villamandos;295;161;134
24;León;901;Villamanín;911;458;453
24;León;212;Villamañán;1102;560;542
24;León;213;Villamartín de Don Sancho;159;86;73
24;León;214;Villamejil;672;362;310
24;León;215;Villamol;152;78;74
24;León;216;Villamontán de la Valduerna;720;381;339
24;León;217;Villamoratiel de las Matas;135;75;60
24;León;218;Villanueva de las Manzanas;494;258;236
24;León;219;Villaobispo de Otero;532;293;239
24;León;902;Villaornate y Castro;334;172;162
24;León;221;Villaquejida;827;424;403
24;León;222;Villaquilambre;18684;9241;9443
24;León;223;Villarejo de Órbigo;2975;1458;1517
24;León;224;Villares de Órbigo;596;318;278
24;León;225;Villasabariego;1123;575;548
24;León;226;Villaselán;194;112;82
24;León;227;Villaturiel;1826;958;868
24;León;228;Villazala;647;344;303
24;León;229;Villazanzo de Valderaduey;397;232;165
24;León;230;Zotes del Páramo;423;240;183
25;Lleida;001;Abella de la Conca;183;99;84
25;Lleida;002;Àger;580;314;266
25;Lleida;003;Agramunt;5411;2710;2701
25;Lleida;038;Aitona;2567;1338;1229
25;Lleida;004;Alamús, Els;811;412;399
25;Lleida;005;Alàs i Cerc;320;158;162
25;Lleida;006;Albagés, L';361;189;172
25;Lleida;007;Albatàrrec;2236;1142;1094
25;Lleida;008;Albesa;1561;848;713
25;Lleida;009;Albi, L';744;378;366
25;Lleida;010;Alcanó;238;121;117
25;Lleida;011;Alcarràs;9707;5096;4611
25;Lleida;012;Alcoletge;3435;1805;1630
25;Lleida;013;Alfarràs;2765;1440;1325
25;Lleida;014;Alfés;297;159;138
25;Lleida;015;Algerri;404;219;185
25;Lleida;016;Alguaire;3029;1606;1423
25;Lleida;017;Alins;272;143;129
25;Lleida;019;Almacelles;6826;3649;3177
25;Lleida;020;Almatret;305;170;135
25;Lleida;021;Almenar;3357;1774;1583
25;Lleida;022;Alòs de Balaguer;132;79;53
25;Lleida;023;Alpicat;6266;3138;3128
25;Lleida;024;Alt Àneu;414;239;175
25;Lleida;027;Anglesola;1365;689;676
25;Lleida;029;Arbeca;2126;1101;1025
25;Lleida;031;Arres;60;39;21
25;Lleida;032;Arsèguel;81;46;35
25;Lleida;033;Artesa de Lleida;1535;816;719
25;Lleida;034;Artesa de Segre;3400;1756;1644
25;Lleida;036;Aspa;220;115;105
25;Lleida;037;Avellanes i Santa Linya, Les;433;249;184
25;Lleida;039;Baix Pallars;331;180;151
25;Lleida;040;Balaguer;17472;8953;8519
25;Lleida;041;Barbens;878;468;410
25;Lleida;042;Baronia de Rialb, La;229;116;113
25;Lleida;044;Bassella;217;112;105
25;Lleida;045;Bausen;60;30;30
25;Lleida;046;Belianes;520;261;259
25;Lleida;170;Bellaguarda;287;150;137
25;Lleida;047;Bellcaire d'Urgell;1199;607;592
25;Lleida;048;Bell-lloc d'Urgell;2335;1159;1176
25;Lleida;049;Bellmunt d'Urgell;185;90;95
25;Lleida;050;Bellpuig;5218;2774;2444
25;Lleida;051;Bellver de Cerdanya;2005;1035;970
25;Lleida;052;Bellvís;2260;1159;1101
25;Lleida;053;Benavent de Segrià;1518;806;712
25;Lleida;055;Biosca;177;94;83
25;Lleida;057;Bòrdes, Es;255;142;113
25;Lleida;058;Borges Blanques, Les;6173;3152;3021
25;Lleida;059;Bossòst;1115;544;571
25;Lleida;056;Bovera;248;138;110
25;Lleida;060;Cabanabona;71;34;37
25;Lleida;061;Cabó;93;50;43
25;Lleida;062;Camarasa;810;406;404
25;Lleida;063;Canejan;89;45;44
25;Lleida;904;Castell de Mur;173;96;77
25;Lleida;064;Castellar de la Ribera;131;66;65
25;Lleida;067;Castelldans;930;497;433
25;Lleida;068;Castellnou de Seana;665;354;311
25;Lleida;069;Castelló de Farfanya;539;291;248
25;Lleida;070;Castellserà;996;505;491
25;Lleida;071;Cava;45;29;16
25;Lleida;072;Cervera;9350;4778;4572
25;Lleida;073;Cervià de les Garrigues;662;350;312
25;Lleida;074;Ciutadilla;208;111;97
25;Lleida;075;Clariana de Cardener;161;86;75
25;Lleida;076;Cogul, El;151;83;68
25;Lleida;077;Coll de Nargó;540;277;263
25;Lleida;163;Coma i la Pedra, La;255;151;104
25;Lleida;161;Conca de Dalt;410;209;201
25;Lleida;078;Corbins;1462;811;651
25;Lleida;079;Cubells;338;179;159
25;Lleida;081;Espluga Calba, L';329;168;161
25;Lleida;082;Espot;366;197;169
25;Lleida;088;Estamariu;125;72;53
25;Lleida;085;Estaràs;156;79;77
25;Lleida;086;Esterri d'Àneu;804;382;422
25;Lleida;087;Esterri de Cardós;64;34;30
25;Lleida;089;Farrera;108;63;45
25;Lleida;908;Fígols i Alinyà;244;140;104
25;Lleida;092;Floresta, La;140;76;64
25;Lleida;093;Fondarella;776;388;388
25;Lleida;094;Foradada;203;132;71
25;Lleida;096;Fuliola, La;1250;620;630
25;Lleida;097;Fulleda;102;53;49
25;Lleida;098;Gavet de la Conca;261;131;130
25;Lleida;912;Gimenells i el Pla de la Font;1120;600;520
25;Lleida;099;Golmés;1855;940;915
25;Lleida;100;Gósol;206;118;88
25;Lleida;101;Granadella, La;716;392;324
25;Lleida;102;Granja d'Escarp, La;922;509;413
25;Lleida;103;Granyanella;143;80;63
25;Lleida;105;Granyena de les Garrigues;140;85;55
25;Lleida;104;Granyena de Segarra;151;82;69
25;Lleida;109;Guimerà;271;141;130
25;Lleida;903;Guingueta d'Àneu, La;289;156;133
25;Lleida;110;Guissona;7248;3893;3355
25;Lleida;111;Guixers;132;80;52
25;Lleida;115;Isona i Conca Dellà;1042;562;480
25;Lleida;112;Ivars de Noguera;332;173;159
25;Lleida;113;Ivars d'Urgell;1537;806;731
25;Lleida;114;Ivorra;108;59;49
25;Lleida;910;Josa i Tuixén;103;59;44
25;Lleida;118;Juncosa;395;206;189
25;Lleida;119;Juneda;3501;1877;1624
25;Lleida;121;Les;971;464;507
25;Lleida;122;Linyola;2717;1367;1350
25;Lleida;123;Lladorre;237;119;118
25;Lleida;124;Lladurs;180;95;85
25;Lleida;125;Llardecans;444;237;207
25;Lleida;126;Llavorsí;346;176;170
25;Lleida;120;Lleida;140403;69541;70862
25;Lleida;127;Lles de Cerdanya;270;157;113
25;Lleida;128;Llimiana;146;86;60
25;Lleida;129;Llobera;188;107;81
25;Lleida;133;Maials;909;500;409
25;Lleida;130;Maldà;227;109;118
25;Lleida;131;Massalcoreig;610;354;256
25;Lleida;132;Massoteres;212;117;95
25;Lleida;134;Menàrguens;813;445;368
25;Lleida;135;Miralcamp;1385;717;668
25;Lleida;137;Mollerussa;14649;7524;7125
25;Lleida;136;Molsosa, La;104;51;53
25;Lleida;139;Montellà i Martinet;578;318;260
25;Lleida;140;Montferrer i Castellbò;1034;559;475
25;Lleida;138;Montgai;643;342;301
25;Lleida;142;Montoliu de Lleida;483;253;230
25;Lleida;141;Montoliu de Segarra;187;102;85
25;Lleida;143;Montornès de Segarra;96;46;50
25;Lleida;145;Nalec;90;46;44
25;Lleida;025;Naut Aran;1836;953;883
25;Lleida;146;Navès;284;146;138
25;Lleida;148;Odèn;258;152;106
25;Lleida;149;Oliana;1843;918;925
25;Lleida;150;Oliola;203;109;94
25;Lleida;151;Olius;981;527;454
25;Lleida;152;Oluges, Les;171;90;81
25;Lleida;153;Omellons, Els;206;110;96
25;Lleida;154;Omells de na Gaia, Els;130;74;56
25;Lleida;155;Organyà;771;387;384
25;Lleida;156;Os de Balaguer;980;501;479
25;Lleida;157;Ossó de Sió;203;97;106
25;Lleida;158;Palau d'Anglesola, El;2166;1071;1095
25;Lleida;164;Penelles;436;255;181
25;Lleida;165;Peramola;347;173;174
25;Lleida;166;Pinell de Solsonès;193;113;80
25;Lleida;167;Pinós;286;152;134
25;Lleida;911;Plans de Sió, Els;491;266;225
25;Lleida;168;Poal, El;670;350;320
25;Lleida;169;Pobla de Cérvoles, La;189;104;85
25;Lleida;171;Pobla de Segur, La;3043;1515;1528
25;Lleida;030;Pont de Bar, El;152;91;61
25;Lleida;173;Pont de Suert, El;2257;1128;1129
25;Lleida;172;Ponts;2644;1337;1307
25;Lleida;174;Portella, La;743;423;320
25;Lleida;175;Prats i Sansor;222;116;106
25;Lleida;176;Preixana;387;200;187
25;Lleida;177;Preixens;418;211;207
25;Lleida;179;Prullans;226;104;122
25;Lleida;180;Puiggròs;278;142;136
25;Lleida;181;Puigverd d'Agramunt;229;131;98
25;Lleida;182;Puigverd de Lleida;1349;694;655
25;Lleida;183;Rialp;641;319;322
25;Lleida;905;Ribera d'Ondara;433;215;218
25;Lleida;185;Ribera d'Urgellet;932;480;452
25;Lleida;186;Riner;263;133;130
25;Lleida;913;Riu de Cerdanya;93;55;38
25;Lleida;189;Rosselló;3237;1663;1574
25;Lleida;190;Salàs de Pallars;327;174;153
25;Lleida;191;Sanaüja;379;198;181
25;Lleida;196;Sant Esteve de la Sarga;122;74;48
25;Lleida;192;Sant Guim de Freixenet;1037;539;498
25;Lleida;197;Sant Guim de la Plana;181;99;82
25;Lleida;193;Sant Llorenç de Morunys;960;467;493
25;Lleida;902;Sant Martí de Riucorb;639;328;311
25;Lleida;194;Sant Ramon;487;259;228
25;Lleida;201;Sarroca de Bellera;116;68;48
25;Lleida;200;Sarroca de Lleida;358;203;155
25;Lleida;202;Senterada;139;82;57
25;Lleida;035;Sentiu de Sió, La;414;217;197
25;Lleida;204;Seròs;1946;1048;898
25;Lleida;203;Seu d'Urgell, La;12206;5919;6287
25;Lleida;205;Sidamon;748;397;351
25;Lleida;206;Soleràs, El;332;175;157
25;Lleida;207;Solsona;9137;4511;4626
25;Lleida;208;Soriguera;420;225;195
25;Lleida;209;Sort;2154;1066;1088
25;Lleida;210;Soses;1761;913;848
25;Lleida;211;Sudanell;840;457;383
25;Lleida;212;Sunyer;343;200;143
25;Lleida;215;Talarn;595;402;193
25;Lleida;216;Talavera;279;156;123
25;Lleida;217;Tàrrega;17445;8658;8787
25;Lleida;218;Tarrés;102;54;48
25;Lleida;219;Tarroja de Segarra;188;99;89
25;Lleida;220;Térmens;1360;688;672
25;Lleida;221;Tírvia;134;63;71
25;Lleida;222;Tiurana;77;34;43
25;Lleida;223;Torà;1237;627;610
25;Lleida;224;Torms, Els;138;74;64
25;Lleida;225;Tornabous;822;440;382
25;Lleida;227;Torre de Cabdella, La;759;381;378
25;Lleida;226;Torrebesses;267;143;124
25;Lleida;228;Torrefarrera;4694;2381;2313
25;Lleida;907;Torrefeta i Florejacs;607;326;281
25;Lleida;230;Torregrossa;2179;1143;1036
25;Lleida;231;Torrelameu;735;443;292
25;Lleida;232;Torres de Segre;2366;1228;1138
25;Lleida;233;Torre-serona;398;208;190
25;Lleida;234;Tremp;5911;2895;3016
25;Lleida;043;Vall de Boí, La;1019;543;476
25;Lleida;901;Vall de Cardós;350;189;161
25;Lleida;238;Vallbona de les Monges;243;127;116
25;Lleida;240;Vallfogona de Balaguer;1906;951;955
25;Lleida;906;Valls d'Aguilar, Les;245;140;105
25;Lleida;239;Valls de Valira, Les;784;404;380
25;Lleida;909;Vansa i Fórnols, La;149;78;71
25;Lleida;242;Verdú;902;421;481
25;Lleida;243;Vielha e Mijaran;5611;2858;2753
25;Lleida;244;Vilagrassa;560;294;266
25;Lleida;245;Vilaller;549;291;258
25;Lleida;247;Vilamòs;178;95;83
25;Lleida;248;Vilanova de Bellpuig;1183;600;583
25;Lleida;254;Vilanova de la Barca;1088;592;496
25;Lleida;249;Vilanova de l'Aguda;200;98;102
25;Lleida;250;Vilanova de Meià;415;249;166
25;Lleida;251;Vilanova de Segrià;985;529;456
25;Lleida;252;Vila-sana;734;373;361
25;Lleida;253;Vilosell, El;173;89;84
25;Lleida;255;Vinaixa;450;235;215
27;Lugo;001;Abadín;2322;1144;1178
27;Lugo;002;Alfoz;1659;803;856
27;Lugo;003;Antas de Ulla;1940;957;983
27;Lugo;004;Baleira;1226;656;570
27;Lugo;901;Baralla;2482;1303;1179
27;Lugo;005;Barreiros;2925;1412;1513
27;Lugo;006;Becerreá;2807;1403;1404
27;Lugo;007;Begonte;2978;1498;1480
27;Lugo;008;Bóveda;1450;742;708
27;Lugo;902;Burela;9498;4722;4776
27;Lugo;009;Carballedo;2139;1073;1066
27;Lugo;010;Castro de Rei;5073;2508;2565
27;Lugo;011;Castroverde;2595;1342;1253
27;Lugo;012;Cervantes;1294;744;550
27;Lugo;013;Cervo;4218;2074;2144
27;Lugo;016;Chantada;8157;3928;4229
27;Lugo;014;Corgo, O;3422;1748;1674
27;Lugo;015;Cospeito;4395;2147;2248
27;Lugo;017;Folgoso do Courel;1007;520;487
27;Lugo;018;Fonsagrada, A;3389;1773;1616
27;Lugo;019;Foz;10016;4876;5140
27;Lugo;020;Friol;3664;1862;1802
27;Lugo;022;Guitiriz;5490;2731;2759
27;Lugo;023;Guntín;2628;1353;1275
27;Lugo;024;Incio, O;1533;770;763
27;Lugo;026;Láncara;2584;1327;1257
27;Lugo;027;Lourenzá;2139;1039;1100
27;Lugo;028;Lugo;98519;45568;52951
27;Lugo;029;Meira;1748;883;865
27;Lugo;030;Mondoñedo;3539;1669;1870
27;Lugo;031;Monforte de Lemos;18347;8712;9635
27;Lugo;032;Monterroso;3613;1793;1820
27;Lugo;033;Muras;619;307;312
27;Lugo;034;Navia de Suarna;1063;589;474
27;Lugo;035;Negueira de Muñiz;215;116;99
27;Lugo;037;Nogais, As;1047;555;492
27;Lugo;038;Ourol;995;508;487
27;Lugo;039;Outeiro de Rei;5210;2676;2534
27;Lugo;040;Palas de Rei;3326;1680;1646
27;Lugo;041;Pantón;2457;1219;1238
27;Lugo;042;Paradela;1739;866;873
27;Lugo;043;Páramo, O;1344;667;677
27;Lugo;044;Pastoriza, A;2963;1494;1469
27;Lugo;045;Pedrafita do Cebreiro;969;527;442
27;Lugo;047;Pobra do Brollón, A;1632;801;831
27;Lugo;046;Pol;1623;809;814
27;Lugo;048;Pontenova, A;2201;1053;1148
27;Lugo;049;Portomarín;1412;734;678
27;Lugo;050;Quiroga;3169;1495;1674
27;Lugo;056;Rábade;1505;747;758
27;Lugo;051;Ribadeo;9860;4691;5169
27;Lugo;052;Ribas de Sil;931;470;461
27;Lugo;053;Ribeira de Piquín;513;268;245
27;Lugo;054;Riotorto;1235;617;618
27;Lugo;055;Samos;1246;662;584
27;Lugo;057;Sarria;13338;6476;6862
27;Lugo;058;Saviñao, O;3634;1847;1787
27;Lugo;059;Sober;2260;1126;1134
27;Lugo;060;Taboada;2716;1296;1420
27;Lugo;061;Trabada;1127;541;586
27;Lugo;062;Triacastela;637;320;317
27;Lugo;063;Valadouro, O;1978;939;1039
27;Lugo;064;Vicedo, O;1656;816;840
27;Lugo;065;Vilalba;14079;6805;7274
27;Lugo;066;Viveiro;15391;7539;7852
27;Lugo;021;Xermade;1783;875;908
27;Lugo;025;Xove;3277;1631;1646
28;Madrid;001;Acebeda, La;68;34;34
28;Madrid;002;Ajalvir;4721;2451;2270
28;Madrid;003;Alameda del Valle;204;120;84
28;Madrid;004;Álamo, El;9862;4849;5013
28;Madrid;005;Alcalá de Henares;197562;96061;101501
28;Madrid;006;Alcobendas;118417;56554;61863
28;Madrid;007;Alcorcón;172384;82959;89425
28;Madrid;008;Aldea del Fresno;2973;1517;1456
28;Madrid;009;Algete;20864;10236;10628
28;Madrid;010;Alpedrete;14839;7277;7562
28;Madrid;011;Ambite;609;308;301
28;Madrid;012;Anchuelo;1286;667;619
28;Madrid;013;Aranjuez;60332;29420;30912
28;Madrid;014;Arganda del Rey;56678;28331;28347
28;Madrid;015;Arroyomolinos;32935;16419;16516
28;Madrid;016;Atazar, El;90;47;43
28;Madrid;017;Batres;1750;887;863
28;Madrid;018;Becerril de la Sierra;5875;2951;2924
28;Madrid;019;Belmonte de Tajo;1683;869;814
28;Madrid;021;Berrueco, El;777;389;388
28;Madrid;020;Berzosa del Lozoya;222;126;96
28;Madrid;022;Boadilla del Monte;56734;27710;29024
28;Madrid;023;Boalo, El;7663;3868;3795
28;Madrid;024;Braojos;206;122;84
28;Madrid;025;Brea de Tajo;506;292;214
28;Madrid;026;Brunete;10760;5302;5458
28;Madrid;027;Buitrago del Lozoya;1959;933;1026
28;Madrid;028;Bustarviejo;2522;1277;1245
28;Madrid;029;Cabanillas de la Sierra;785;407;378
28;Madrid;030;Cabrera, La;2736;1334;1402
28;Madrid;031;Cadalso de los Vidrios;3047;1572;1475
28;Madrid;032;Camarma de Esteruelas;7437;3780;3657
28;Madrid;033;Campo Real;6420;3259;3161
28;Madrid;034;Canencia;447;242;205
28;Madrid;035;Carabaña;2081;1055;1026
28;Madrid;036;Casarrubuelos;3845;1973;1872
28;Madrid;037;Cenicientos;2038;1019;1019
28;Madrid;038;Cercedilla;7205;3551;3654
28;Madrid;039;Cervera de Buitrago;162;97;65
28;Madrid;051;Chapinería;2414;1219;1195
28;Madrid;052;Chinchón;5413;2733;2680
28;Madrid;040;Ciempozuelos;25104;12674;12430
28;Madrid;041;Cobeña;7486;3667;3819
28;Madrid;046;Collado Mediano;7105;3524;3581
28;Madrid;047;Collado Villalba;64378;31210;33168
28;Madrid;043;Colmenar de Oreja;8154;4128;4026
28;Madrid;042;Colmenar del Arroyo;1785;923;862
28;Madrid;045;Colmenar Viejo;51938;25618;26320
28;Madrid;044;Colmenarejo;9230;4515;4715
28;Madrid;048;Corpa;723;374;349
28;Madrid;049;Coslada;81391;39821;41570
28;Madrid;050;Cubas de la Sagra;6539;3229;3310
28;Madrid;053;Daganzo de Arriba;10337;5155;5182
28;Madrid;054;Escorial, El;16365;8067;8298
28;Madrid;055;Estremera;1334;680;654
28;Madrid;056;Fresnedillas de la Oliva;1651;840;811
28;Madrid;057;Fresno de Torote;2299;1215;1084
28;Madrid;058;Fuenlabrada;194514;95847;98667
28;Madrid;059;Fuente el Saz de Jarama;6807;3426;3381
28;Madrid;060;Fuentidueña de Tajo;2136;1073;1063
28;Madrid;061;Galapagar;34497;16822;17675
28;Madrid;062;Garganta de los Montes;377;203;174
28;Madrid;063;Gargantilla del Lozoya y Pinilla de Buitrago;309;165;144
28;Madrid;064;Gascones;176;98;78
28;Madrid;065;Getafe;185180;90403;94777
28;Madrid;066;Griñón;10435;5211;5224
28;Madrid;067;Guadalix de la Sierra;6440;3253;3187
28;Madrid;068;Guadarrama;16560;8157;8403
28;Madrid;069;Hiruela, La;65;45;20
28;Madrid;070;Horcajo de la Sierra-Aoslos;152;80;72
28;Madrid;071;Horcajuelo de la Sierra;89;50;39
28;Madrid;072;Hoyo de Manzanares;8529;4299;4230
28;Madrid;073;Humanes de Madrid;19701;9799;9902
28;Madrid;074;Leganés;191114;92573;98541
28;Madrid;075;Loeches;8897;4472;4425
28;Madrid;076;Lozoya;580;306;274
28;Madrid;901;Lozoyuela-Navas-Sieteiglesias;1340;694;646
28;Madrid;078;Madarcos;49;30;19
28;Madrid;079;Madrid;3334730;1553899;1780831
28;Madrid;080;Majadahonda;72155;34170;37985
28;Madrid;082;Manzanares el Real;8936;4541;4395
28;Madrid;083;Meco;14670;7388;7282
28;Madrid;084;Mejorada del Campo;23639;11752;11887
28;Madrid;085;Miraflores de la Sierra;6362;3265;3097
28;Madrid;086;Molar, El;9287;4718;4569
28;Madrid;087;Molinos, Los;4433;2181;2252
28;Madrid;088;Montejo de la Sierra;364;188;176
28;Madrid;089;Moraleja de Enmedio;5200;2591;2609
28;Madrid;090;Moralzarzal;13334;6666;6668
28;Madrid;091;Morata de Tajuña;7847;3933;3914
28;Madrid;092;Móstoles;210309;102307;108002
28;Madrid;093;Navacerrada;3091;1552;1539
28;Madrid;094;Navalafuente;1511;774;737
28;Madrid;095;Navalagamella;2637;1362;1275
28;Madrid;096;Navalcarnero;29985;14899;15086
28;Madrid;097;Navarredonda y San Mamés;129;84;45
28;Madrid;099;Navas del Rey;2966;1551;1415
28;Madrid;100;Nuevo Baztán;6454;3295;3159
28;Madrid;101;Olmeda de las Fuentes;346;178;168
28;Madrid;102;Orusco de Tajuña;1295;654;641
28;Madrid;104;Paracuellos de Jarama;25917;13015;12902
28;Madrid;106;Parla;133482;66524;66958
28;Madrid;107;Patones;539;251;288
28;Madrid;108;Pedrezuela;6150;3063;3087
28;Madrid;109;Pelayos de la Presa;2676;1366;1310
28;Madrid;110;Perales de Tajuña;2990;1517;1473
28;Madrid;111;Pezuela de las Torres;867;460;407
28;Madrid;112;Pinilla del Valle;190;106;84
28;Madrid;113;Pinto;53325;26426;26899
28;Madrid;114;Piñuécar-Gandullas;179;91;88
28;Madrid;115;Pozuelo de Alarcón;87165;41766;45399
28;Madrid;116;Pozuelo del Rey;1172;618;554
28;Madrid;117;Prádena del Rincón;125;70;55
28;Madrid;118;Puebla de la Sierra;73;42;31
28;Madrid;902;Puentes Viejas;699;390;309
28;Madrid;119;Quijorna;3541;1771;1770
28;Madrid;120;Rascafría;1725;942;783
28;Madrid;121;Redueña;270;155;115
28;Madrid;122;Ribatejada;801;406;395
28;Madrid;123;Rivas-Vaciamadrid;90973;45073;45900
28;Madrid;124;Robledillo de la Jara;95;48;47
28;Madrid;125;Robledo de Chavela;4364;2274;2090
28;Madrid;126;Robregordo;65;40;25
28;Madrid;127;Rozas de Madrid, Las;96113;46420;49693
28;Madrid;128;Rozas de Puerto Real;555;320;235
28;Madrid;129;San Agustín del Guadalix;13466;6613;6853
28;Madrid;130;San Fernando de Henares;39566;19244;20322
28;Madrid;131;San Lorenzo de El Escorial;18532;8880;9652
28;Madrid;132;San Martín de la Vega;19633;10051;9582
28;Madrid;133;San Martín de Valdeiglesias;8679;4319;4360
28;Madrid;134;San Sebastián de los Reyes;91224;44477;46747
28;Madrid;135;Santa María de la Alameda;1321;700;621
28;Madrid;136;Santorcaz;899;463;436
28;Madrid;137;Santos de la Humosa, Los;2694;1380;1314
28;Madrid;138;Serna del Monte, La;87;47;40
28;Madrid;140;Serranillos del Valle;4291;2111;2180
28;Madrid;141;Sevilla la Nueva;9393;4582;4811
28;Madrid;143;Somosierra;87;50;37
28;Madrid;144;Soto del Real;8981;4399;4582
28;Madrid;145;Talamanca de Jarama;4012;1992;2020
28;Madrid;146;Tielmes;2736;1389;1347
28;Madrid;147;Titulcia;1341;695;646
28;Madrid;148;Torrejón de Ardoz;132853;65343;67510
28;Madrid;149;Torrejón de la Calzada;9194;4559;4635
28;Madrid;150;Torrejón de Velasco;4386;2193;2193
28;Madrid;151;Torrelaguna;4854;2435;2419
28;Madrid;152;Torrelodones;23902;11548;12354
28;Madrid;153;Torremocha de Jarama;1075;542;533
28;Madrid;154;Torres de la Alameda;7833;4002;3831
28;Madrid;903;Tres Cantos;48326;23439;24887
28;Madrid;155;Valdaracete;605;311;294
28;Madrid;156;Valdeavero;1591;828;763
28;Madrid;157;Valdelaguna;979;491;488
28;Madrid;158;Valdemanco;963;498;465
28;Madrid;159;Valdemaqueda;775;397;378
28;Madrid;160;Valdemorillo;12772;6429;6343
28;Madrid;161;Valdemoro;77270;38142;39128
28;Madrid;162;Valdeolmos-Alalpardo;4232;2170;2062
28;Madrid;163;Valdepiélagos;614;325;289
28;Madrid;164;Valdetorres de Jarama;4581;2310;2271
28;Madrid;165;Valdilecha;2982;1533;1449
28;Madrid;166;Valverde de Alcalá;498;262;236
28;Madrid;167;Velilla de San Antonio;12380;6237;6143
28;Madrid;168;Vellón, El;2004;1055;949
28;Madrid;169;Venturada;2241;1179;1062
28;Madrid;171;Villa del Prado;6661;3393;3268
28;Madrid;170;Villaconejos;3422;1758;1664
28;Madrid;172;Villalbilla;14392;7256;7136
28;Madrid;173;Villamanrique de Tajo;707;354;353
28;Madrid;174;Villamanta;2605;1315;1290
28;Madrid;175;Villamantilla;1482;726;756
28;Madrid;176;Villanueva de la Cañada;22115;10756;11359
28;Madrid;178;Villanueva de Perales;1592;813;779
28;Madrid;177;Villanueva del Pardillo;17396;8462;8934
28;Madrid;179;Villar del Olmo;2079;1024;1055
28;Madrid;180;Villarejo de Salvanés;7433;3716;3717
28;Madrid;181;Villaviciosa de Odón;28148;13604;14544
28;Madrid;182;Villavieja del Lozoya;262;140;122
28;Madrid;183;Zarzalejo;1734;891;843
29;Málaga;001;Alameda;5387;2724;2663
29;Málaga;002;Alcaucín;2279;1172;1107
29;Málaga;003;Alfarnate;1065;545;520
29;Málaga;004;Alfarnatejo;364;184;180
29;Málaga;005;Algarrobo;6556;3296;3260
29;Málaga;006;Algatocín;814;420;394
29;Málaga;007;Alhaurín de la Torre;41170;20437;20733
29;Málaga;008;Alhaurín el Grande;25358;12671;12687
29;Málaga;009;Almáchar;1817;935;882
29;Málaga;010;Almargen;1947;992;955
29;Málaga;011;Almogía;3792;1969;1823
29;Málaga;012;Álora;13112;6633;6479
29;Málaga;013;Alozaina;2061;1048;1013
29;Málaga;014;Alpandeire;263;129;134
29;Málaga;015;Antequera;41318;20215;21103
29;Málaga;016;Árchez;385;201;184
29;Málaga;017;Archidona;8168;4163;4005
29;Málaga;018;Ardales;2506;1270;1236
29;Málaga;019;Arenas;1177;617;560
29;Málaga;020;Arriate;4082;2017;2065
29;Málaga;021;Atajate;169;92;77
29;Málaga;022;Benadalid;233;117;116
29;Málaga;023;Benahavís;7748;3850;3898
29;Málaga;024;Benalauría;438;231;207
29;Málaga;025;Benalmádena;69144;33892;35252
29;Málaga;026;Benamargosa;1535;799;736
29;Málaga;027;Benamocarra;3046;1522;1524
29;Málaga;028;Benaoján;1453;743;710
29;Málaga;029;Benarrabá;446;233;213
29;Málaga;030;Borge, El;922;474;448
29;Málaga;031;Burgo, El;1792;922;870
29;Málaga;032;Campillos;8387;4219;4168
29;Málaga;033;Canillas de Aceituno;1680;882;798
29;Málaga;034;Canillas de Albaida;759;375;384
29;Málaga;035;Cañete la Real;1633;819;814
29;Málaga;036;Carratraca;740;387;353
29;Málaga;037;Cartajima;242;129;113
29;Málaga;038;Cártama;26738;13523;13215
29;Málaga;039;Casabermeja;3629;1904;1725
29;Málaga;040;Casarabonela;2514;1339;1175
29;Málaga;041;Casares;6883;3526;3357
29;Málaga;042;Coín;22673;11358;11315
29;Málaga;043;Colmenar;3409;1741;1668
29;Málaga;044;Comares;1330;725;605
29;Málaga;045;Cómpeta;3967;1980;1987
29;Málaga;046;Cortes de la Frontera;3065;1586;1479
29;Málaga;047;Cuevas Bajas;1370;680;690
29;Málaga;049;Cuevas de San Marcos;3601;1810;1791
29;Málaga;048;Cuevas del Becerro;1597;785;812
29;Málaga;050;Cútar;616;321;295
29;Málaga;051;Estepona;70228;34392;35836
29;Málaga;052;Faraján;261;128;133
29;Málaga;053;Frigiliana;3062;1520;1542
29;Málaga;054;Fuengirola;82837;40441;42396
29;Málaga;055;Fuente de Piedra;2662;1353;1309
29;Málaga;056;Gaucín;1589;830;759
29;Málaga;057;Genalguacil;393;196;197
29;Málaga;058;Guaro;2280;1156;1124
29;Málaga;059;Humilladero;3297;1647;1650
29;Málaga;060;Igualeja;752;378;374
29;Málaga;061;Istán;1494;743;751
29;Málaga;062;Iznate;907;468;439
29;Málaga;063;Jimera de Líbar;379;197;182
29;Málaga;064;Jubrique;523;261;262
29;Málaga;065;Júzcar;214;124;90
29;Málaga;066;Macharaviaya;513;279;234
29;Málaga;067;Málaga;578460;277789;300671
29;Málaga;068;Manilva;16439;8304;8135
29;Málaga;069;Marbella;147633;70833;76800
29;Málaga;070;Mijas;85397;42430;42967
29;Málaga;071;Moclinejo;1251;650;601
29;Málaga;072;Mollina;5276;2643;2633
29;Málaga;073;Monda;2697;1388;1309
29;Málaga;903;Montecorto;586;309;277
29;Málaga;074;Montejaque;949;472;477
29;Málaga;075;Nerja;21144;10431;10713
29;Málaga;076;Ojén;3816;1946;1870
29;Málaga;077;Parauta;239;123;116
29;Málaga;079;Periana;3089;1618;1471
29;Málaga;080;Pizarra;9444;4741;4703
29;Málaga;081;Pujerra;308;162;146
29;Málaga;082;Rincón de la Victoria;48768;23899;24869
29;Málaga;083;Riogordo;2723;1416;1307
29;Málaga;084;Ronda;33730;16362;17368
29;Málaga;085;Salares;173;86;87
29;Málaga;086;Sayalonga;1568;817;751
29;Málaga;087;Sedella;576;327;249
29;Málaga;904;Serrato;482;241;241
29;Málaga;088;Sierra de Yeguas;3318;1676;1642
29;Málaga;089;Teba;3744;1870;1874
29;Málaga;090;Tolox;2136;1081;1055
29;Málaga;901;Torremolinos;69166;34603;34563
29;Málaga;091;Torrox;17943;9026;8917
29;Málaga;092;Totalán;737;376;361
29;Málaga;093;Valle de Abdalajís;2502;1278;1224
29;Málaga;094;Vélez-Málaga;82365;40548;41817
29;Málaga;095;Villanueva de Algaidas;4148;2119;2029
29;Málaga;902;Villanueva de la Concepción;3288;1606;1682
29;Málaga;098;Villanueva de Tapia;1460;736;724
29;Málaga;096;Villanueva del Rosario;3362;1638;1724
29;Málaga;097;Villanueva del Trabuco;5308;2648;2660
29;Málaga;099;Viñuela;2055;1079;976
29;Málaga;100;Yunquera;2869;1464;1405
52;Melilla;001;Melilla;87076;44162;42914
30;Murcia;001;Abanilla;6097;3096;3001
30;Murcia;002;Abarán;13022;6514;6508
30;Murcia;003;Águilas;35722;17832;17890
30;Murcia;004;Albudeite;1375;699;676
30;Murcia;005;Alcantarilla;42345;20981;21364
30;Murcia;902;Alcázares, Los;16590;8495;8095
30;Murcia;006;Aledo;1031;512;519
30;Murcia;007;Alguazas;9761;5032;4729
30;Murcia;008;Alhama de Murcia;22160;11202;10958
30;Murcia;009;Archena;19428;10205;9223
30;Murcia;010;Beniel;11465;5977;5488
30;Murcia;011;Blanca;6569;3360;3209
30;Murcia;012;Bullas;11553;5805;5748
30;Murcia;013;Calasparra;10133;5142;4991
30;Murcia;014;Campos del Río;2032;959;1073
30;Murcia;015;Caravaca de la Cruz;25688;12857;12831
30;Murcia;016;Cartagena;216108;107478;108630
30;Murcia;017;Cehegín;14769;7395;7374
30;Murcia;018;Ceutí;12007;6048;5959
30;Murcia;019;Cieza;35283;17731;17552
30;Murcia;020;Fortuna;10289;5494;4795
30;Murcia;021;Fuente Álamo de Murcia;16787;8687;8100
30;Murcia;022;Jumilla;25994;13554;12440
30;Murcia;023;Librilla;5325;2728;2597
30;Murcia;024;Lorca;95515;48838;46677
30;Murcia;025;Lorquí;7246;3646;3600
30;Murcia;026;Mazarrón;32839;16998;15841
30;Murcia;027;Molina de Segura;73095;36494;36601
30;Murcia;028;Moratalla;7804;3951;3853
30;Murcia;029;Mula;17021;8722;8299
30;Murcia;030;Murcia;459403;224929;234474
30;Murcia;031;Ojós;510;267;243
30;Murcia;032;Pliego;3843;1981;1862
30;Murcia;033;Puerto Lumbreras;15780;7998;7782
30;Murcia;034;Ricote;1253;668;585
30;Murcia;035;San Javier;33129;16658;16471
30;Murcia;036;San Pedro del Pinatar;25932;13069;12863
30;Murcia;901;Santomera;16270;8147;8123
30;Murcia;037;Torre-Pacheco;36464;18797;17667
30;Murcia;038;Torres de Cotillas, Las;21753;11058;10695
30;Murcia;039;Totana;32529;16774;15755
30;Murcia;040;Ulea;849;443;406
30;Murcia;041;Unión, La;20538;10418;10120
30;Murcia;042;Villanueva del Río Segura;3111;1558;1553
30;Murcia;043;Yecla;34834;17502;17332
31;Navarra;001;Abáigar;82;47;35
31;Navarra;002;Abárzuza/Abartzuza;544;277;267
31;Navarra;003;Abaurregaina/Abaurrea Alta;127;80;47
31;Navarra;004;Abaurrepea/Abaurrea Baja;31;18;13
31;Navarra;005;Aberin;340;181;159
31;Navarra;006;Ablitas;2484;1261;1223
31;Navarra;007;Adiós;152;87;65
31;Navarra;008;Aguilar de Codés;66;38;28
31;Navarra;009;Aibar/Oibar;794;416;378
31;Navarra;011;Allín/Allin;874;463;411
31;Navarra;012;Allo;960;487;473
31;Navarra;010;Altsasu/Alsasua;7465;3765;3700
31;Navarra;013;Améscoa Baja;711;390;321
31;Navarra;014;Ancín/Antzin;338;188;150
31;Navarra;015;Andosilla;2784;1419;1365
31;Navarra;016;Ansoáin/Antsoain;10836;5327;5509
31;Navarra;017;Anue;481;260;221
31;Navarra;018;Añorbe;595;328;267
31;Navarra;019;Aoiz/Agoitz;2777;1414;1363
31;Navarra;020;Araitz;523;289;234
31;Navarra;025;Arakil;962;506;456
31;Navarra;021;Aranarache/Aranaratxe;70;40;30
31;Navarra;023;Aranguren;11306;5698;5608
31;Navarra;024;Arano;116;62;54
31;Navarra;022;Arantza;608;323;285
31;Navarra;026;Aras;147;79;68
31;Navarra;027;Arbizu;1109;579;530
31;Navarra;028;Arce/Artzi;262;142;120
31;Navarra;029;Arcos, Los;1127;556;571
31;Navarra;030;Arellano;148;80;68
31;Navarra;031;Areso;283;146;137
31;Navarra;032;Arguedas;2287;1175;1112
31;Navarra;033;Aria;51;30;21
31;Navarra;034;Aribe;32;18;14
31;Navarra;035;Armañanzas;52;28;24
31;Navarra;036;Arróniz;1038;557;481
31;Navarra;037;Arruazu;106;55;51
31;Navarra;038;Artajona;1691;875;816
31;Navarra;039;Artazu;111;57;54
31;Navarra;040;Atez/Atetz;225;125;100
31;Navarra;058;Auritz/Burguete;227;122;105
31;Navarra;041;Ayegui/Aiegi;2395;1243;1152
31;Navarra;042;Azagra;3840;1942;1898
31;Navarra;043;Azuelo;26;10;16
31;Navarra;044;Bakaiku;360;192;168
31;Navarra;901;Barañáin/Barañain;20167;9771;10396
31;Navarra;045;Barásoain;613;327;286
31;Navarra;046;Barbarin;49;25;24
31;Navarra;047;Bargota;255;126;129
31;Navarra;048;Barillas;221;121;100
31;Navarra;049;Basaburua;828;467;361
31;Navarra;050;Baztan;7850;3969;3881
31;Navarra;137;Beintza-Labaien;217;128;89
31;Navarra;051;Beire;287;153;134
31;Navarra;052;Belascoáin;119;62;57
31;Navarra;250;Bera;3753;1851;1902
31;Navarra;053;Berbinzana;666;340;326
31;Navarra;905;Beriáin;4113;2025;2088
31;Navarra;902;Berrioplano/Berriobeiti;7457;3801;3656
31;Navarra;903;Berriozar;10651;5348;5303
31;Navarra;054;Bertizarana;603;297;306
31;Navarra;055;Betelu;374;190;184
31;Navarra;253;Bidaurreta;164;87;77
31;Navarra;056;Biurrun-Olcoz;223;126;97
31;Navarra;057;Buñuel;2195;1076;1119
31;Navarra;059;Burgui/Burgi;203;114;89
31;Navarra;060;Burlada/Burlata;19541;9462;10079
31;Navarra;061;Busto, El;54;25;29
31;Navarra;062;Cabanillas;1351;712;639
31;Navarra;063;Cabredo;87;49;38
31;Navarra;064;Cadreita;2045;1064;981
31;Navarra;065;Caparroso;2801;1493;1308
31;Navarra;066;Cárcar;1104;560;544
31;Navarra;067;Carcastillo;2502;1271;1231
31;Navarra;068;Cascante;3952;1958;1994
31;Navarra;069;Cáseda;951;479;472
31;Navarra;070;Castejón;4251;2131;2120
31;Navarra;071;Castillonuevo;13;8;5
31;Navarra;193;Cendea de Olza/Oltza Zendea;1860;914;946
31;Navarra;072;Cintruénigo;8026;4118;3908
31;Navarra;074;Cirauqui/Zirauki;480;249;231
31;Navarra;075;Ciriza/Ziritza;153;74;79
31;Navarra;076;Cizur;3924;2037;1887
31;Navarra;077;Corella;8100;4070;4030
31;Navarra;078;Cortes;3178;1630;1548
31;Navarra;079;Desojo;76;44;32
31;Navarra;080;Dicastillo;591;301;290
31;Navarra;081;Donamaria;442;223;219
31;Navarra;221;Doneztebe/Santesteban;1763;886;877
31;Navarra;083;Echarri/Etxarri;75;37;38
31;Navarra;087;Elgorriaga;220;112;108
31;Navarra;089;Enériz/Eneritz;292;148;144
31;Navarra;090;Eratsun;150;93;57
31;Navarra;091;Ergoiena;370;199;171
31;Navarra;092;Erro;793;446;347
31;Navarra;094;Eslava;105;48;57
31;Navarra;095;Esparza de Salazar/Espartza Zaraitzu;72;39;33
31;Navarra;096;Espronceda;101;57;44
31;Navarra;097;Estella-Lizarra;13991;6696;7295
31;Navarra;098;Esteribar;2726;1403;1323
31;Navarra;099;Etayo;61;34;27
31;Navarra;082;Etxalar;827;430;397
31;Navarra;084;Etxarri Aranatz;2497;1297;1200
31;Navarra;085;Etxauri;649;332;317
31;Navarra;100;Eulate;282;157;125
31;Navarra;101;Ezcabarte;1811;939;872
31;Navarra;093;Ezcároz/Ezkaroze;314;171;143
31;Navarra;102;Ezkurra;138;92;46
31;Navarra;103;Ezprogui;44;22;22
31;Navarra;104;Falces;2336;1202;1134
31;Navarra;105;Fitero;2080;1037;1043
31;Navarra;106;Fontellas;993;496;497
31;Navarra;107;Funes;2444;1292;1152
31;Navarra;108;Fustiñana;2483;1244;1239
31;Navarra;109;Galar;2290;1196;1094
31;Navarra;110;Gallipienzo/Galipentzu;94;52;42
31;Navarra;111;Gallués/Galoze;94;62;32
31;Navarra;112;Garaioa;94;54;40
31;Navarra;113;Garde;142;83;59
31;Navarra;114;Garínoain;498;262;236
31;Navarra;115;Garralda;191;98;93
31;Navarra;116;Genevilla;66;42;24
31;Navarra;117;Goizueta;689;369;320
31;Navarra;118;Goñi;157;100;57
31;Navarra;119;Güesa/Gorza;36;22;14
31;Navarra;120;Guesálaz/Gesalatz;421;247;174
31;Navarra;121;Guirguillano;83;43;40
31;Navarra;256;Hiriberri/Villanueva de Aezkoa;100;54;46
31;Navarra;122;Huarte/Uharte;7278;3655;3623
31;Navarra;124;Ibargoiti;248;148;100
31;Navarra;259;Igantzi;631;335;296
31;Navarra;125;Igúzquiza;318;163;155
31;Navarra;126;Imotz;430;233;197
31;Navarra;127;Irañeta;169;92;77
31;Navarra;904;Irurtzun;2247;1162;1085
31;Navarra;128;Isaba/Izaba;403;194;209
31;Navarra;129;Ituren;507;257;250
31;Navarra;130;Iturmendi;411;213;198
31;Navarra;131;Iza/Itza;1262;680;582
31;Navarra;132;Izagaondoa;172;111;61
31;Navarra;133;Izalzu/Itzaltzu;37;21;16
31;Navarra;134;Jaurrieta;186;106;80
31;Navarra;135;Javier;128;32;96
31;Navarra;136;Juslapeña;568;315;253
31;Navarra;138;Lakuntza;1275;679;596
31;Navarra;139;Lana;163;91;72
31;Navarra;140;Lantz;152;89;63
31;Navarra;141;Lapoblación;122;69;53
31;Navarra;142;Larraga;2123;1125;998
31;Navarra;143;Larraona;96;49;47
31;Navarra;144;Larraun;928;512;416
31;Navarra;145;Lazagurría;185;95;90
31;Navarra;146;Leache/Leatxe;33;18;15
31;Navarra;147;Legarda;125;66;59
31;Navarra;148;Legaria;115;50;65
31;Navarra;149;Leitza;2965;1519;1446
31;Navarra;908;Lekunberri;1574;797;777
31;Navarra;150;Leoz/Leotz;224;146;78
31;Navarra;151;Lerga;46;29;17
31;Navarra;152;Lerín;1746;895;851
31;Navarra;153;Lesaka;2744;1403;1341
31;Navarra;154;Lezaun;238;141;97
31;Navarra;155;Liédena;295;151;144
31;Navarra;156;Lizoáin-Arriasgoiti;294;173;121
31;Navarra;157;Lodosa;4837;2454;2383
31;Navarra;158;Lónguida/Longida;297;157;140
31;Navarra;159;Lumbier;1299;702;597
31;Navarra;160;Luquin;131;68;63
31;Navarra;248;Luzaide/Valcarlos;323;176;147
31;Navarra;161;Mañeru;426;221;205
31;Navarra;162;Marañón;51;26;25
31;Navarra;163;Marcilla;2864;1430;1434
31;Navarra;164;Mélida;731;374;357
31;Navarra;165;Mendavia;3526;1804;1722
31;Navarra;166;Mendaza;291;147;144
31;Navarra;167;Mendigorria;1094;576;518
31;Navarra;168;Metauten;283;156;127
31;Navarra;169;Milagro;3450;1786;1664
31;Navarra;170;Mirafuentes;55;27;28
31;Navarra;171;Miranda de Arga;863;442;421
31;Navarra;172;Monreal/Elo;472;260;212
31;Navarra;173;Monteagudo;1093;557;536
31;Navarra;174;Morentin;115;56;59
31;Navarra;175;Mues;73;41;32
31;Navarra;176;Murchante;4131;2087;2044
31;Navarra;177;Murieta;338;177;161
31;Navarra;178;Murillo el Cuende;673;347;326
31;Navarra;179;Murillo el Fruto;662;354;308
31;Navarra;180;Muruzábal;235;103;132
31;Navarra;181;Navascués/Nabaskoze;126;74;52
31;Navarra;182;Nazar;30;17;13
31;Navarra;088;Noáin (Valle de Elorz)/Noain (Elortzibar);8354;4182;4172
31;Navarra;183;Obanos;940;472;468
31;Navarra;185;Ochagavía/Otsagabia;501;272;229
31;Navarra;184;Oco;75;38;37
31;Navarra;186;Odieta;355;196;159
31;Navarra;187;Oiz;128;74;54
31;Navarra;188;Olaibar;392;224;168
31;Navarra;189;Olazti/Olazagutía;1490;751;739
31;Navarra;190;Olejua;49;27;22
31;Navarra;191;Olite/Erriberri;3981;2011;1970
31;Navarra;192;Olóriz/Oloritz;204;115;89
31;Navarra;195;Orbaizeta;192;94;98
31;Navarra;196;Orbara;32;17;15
31;Navarra;197;Orísoain;79;44;35
31;Navarra;906;Orkoien;4145;2089;2056
31;Navarra;198;Oronz/Orontze;48;23;25
31;Navarra;199;Oroz-Betelu/Orotz-Betelu;147;84;63
31;Navarra;211;Orreaga/Roncesvalles;18;8;10
31;Navarra;200;Oteiza;930;498;432
31;Navarra;201;Pamplona/Iruña;203944;96368;107576
31;Navarra;202;Peralta/Azkoien;5951;3016;2935
31;Navarra;203;Petilla de Aragón;31;17;14
31;Navarra;204;Piedramillera;37;23;14
31;Navarra;205;Pitillas;502;250;252
31;Navarra;206;Puente la Reina/Gares;2889;1472;1417
31;Navarra;207;Pueyo;361;200;161
31;Navarra;208;Ribaforada;3738;1951;1787
31;Navarra;209;Romanzado;171;92;79
31;Navarra;210;Roncal/Erronkari;211;111;100
31;Navarra;212;Sada;135;79;56
31;Navarra;213;Saldías;116;62;54
31;Navarra;214;Salinas de Oro/Jaitz;109;60;49
31;Navarra;215;San Adrián;6344;3134;3210
31;Navarra;217;San Martín de Unx;389;208;181
31;Navarra;216;Sangüesa/Zangoza;4933;2521;2412
31;Navarra;219;Sansol;97;50;47
31;Navarra;220;Santacara;870;451;419
31;Navarra;222;Sarriés/Sartze;60;41;19
31;Navarra;223;Sartaguda;1281;661;620
31;Navarra;224;Sesma;1161;588;573
31;Navarra;225;Sorlada;57;36;21
31;Navarra;226;Sunbilla;665;340;325
31;Navarra;227;Tafalla;10621;5279;5342
31;Navarra;228;Tiebas-Muruarte de Reta;636;336;300
31;Navarra;229;Tirapu;42;26;16
31;Navarra;230;Torralba del Río;96;50;46
31;Navarra;231;Torres del Río;124;61;63
31;Navarra;232;Tudela;37042;18311;18731
31;Navarra;233;Tulebras;132;58;74
31;Navarra;234;Ucar;176;99;77
31;Navarra;123;Uharte Arakil;789;414;375
31;Navarra;235;Ujué/Uxue;175;99;76
31;Navarra;236;Ultzama;1674;859;815
31;Navarra;237;Unciti;209;114;95
31;Navarra;238;Unzué/Untzue;154;81;73
31;Navarra;239;Urdazubi/Urdax;356;175;181
31;Navarra;240;Urdiain;661;343;318
31;Navarra;241;Urraul Alto;137;87;50
31;Navarra;242;Urraul Bajo;317;145;172
31;Navarra;244;Urroz;184;102;82
31;Navarra;243;Urroz-Villa;386;201;185
31;Navarra;245;Urzainqui/Urzainki;87;54;33
31;Navarra;246;Uterga;163;95;68
31;Navarra;247;Uztárroz/Uztarroze;144;76;68
31;Navarra;086;Valle de Egüés/Eguesibar;21418;10734;10684
31;Navarra;194;Valle de Ollo/Ollaran;422;237;185
31;Navarra;260;Valle de Yerri/Deierri;1543;802;741
31;Navarra;249;Valtierra;2430;1227;1203
31;Navarra;251;Viana;4260;2176;2084
31;Navarra;252;Vidángoz/Bidankoze;85;49;36
31;Navarra;254;Villafranca;2883;1457;1426
31;Navarra;255;Villamayor de Monjardín;120;61;59
31;Navarra;257;Villatuerta;1220;606;614
31;Navarra;258;Villava/Atarrabia;10245;4991;5254
31;Navarra;261;Yesa;285;165;120
31;Navarra;262;Zabalza/Zabaltza;301;162;139
31;Navarra;073;Ziordia;350;185;165
31;Navarra;907;Zizur Mayor/Zizur Nagusia;15088;7357;7731
31;Navarra;263;Zubieta;302;155;147
31;Navarra;264;Zugarramurdi;217;107;110
31;Navarra;265;Zúñiga;99;63;36
32;Ourense;001;Allariz;6245;3112;3133
32;Ourense;002;Amoeiro;2296;1155;1141
32;Ourense;003;Arnoia, A;977;489;488
32;Ourense;004;Avión;1736;798;938
32;Ourense;005;Baltar;942;512;430
32;Ourense;006;Bande;1498;749;749
32;Ourense;007;Baños de Molgas;1493;743;750
32;Ourense;008;Barbadás;11158;5450;5708
32;Ourense;009;Barco de Valdeorras, O;13431;6533;6898
32;Ourense;010;Beade;384;198;186
32;Ourense;011;Beariz;970;436;534
32;Ourense;012;Blancos, Os;755;405;350
32;Ourense;013;Boborás;2223;1063;1160
32;Ourense;014;Bola, A;1113;518;595
32;Ourense;015;Bolo, O;850;429;421
32;Ourense;016;Calvos de Randín;735;375;360
32;Ourense;018;Carballeda de Avia;1271;619;652
32;Ourense;017;Carballeda de Valdeorras;1499;783;716
32;Ourense;019;Carballiño, O;14089;6527;7562
32;Ourense;020;Cartelle;2589;1270;1319
32;Ourense;022;Castrelo de Miño;1340;675;665
32;Ourense;021;Castrelo do Val;958;481;477
32;Ourense;023;Castro Caldelas;1204;614;590
32;Ourense;024;Celanova;5644;2651;2993
32;Ourense;025;Cenlle;1100;543;557
32;Ourense;029;Chandrexa de Queixa;472;269;203
32;Ourense;026;Coles;3075;1559;1516
32;Ourense;027;Cortegada;1070;531;539
32;Ourense;028;Cualedro;1668;866;802
32;Ourense;030;Entrimo;1109;529;580
32;Ourense;031;Esgos;1103;568;535
32;Ourense;033;Gomesende;714;347;367
32;Ourense;034;Gudiña, A;1236;626;610
32;Ourense;035;Irixo, O;1420;684;736
32;Ourense;038;Larouco;417;204;213
32;Ourense;039;Laza;1223;644;579
32;Ourense;040;Leiro;1525;744;781
32;Ourense;041;Lobeira;768;377;391
32;Ourense;042;Lobios;1678;839;839
32;Ourense;043;Maceda;2839;1414;1425
32;Ourense;044;Manzaneda;843;410;433
32;Ourense;045;Maside;2709;1347;1362
32;Ourense;046;Melón;1156;556;600
32;Ourense;047;Merca, A;1912;941;971
32;Ourense;048;Mezquita, A;1013;529;484
32;Ourense;049;Montederramo;699;372;327
32;Ourense;050;Monterrei;2520;1279;1241
32;Ourense;051;Muíños;1466;741;725
32;Ourense;052;Nogueira de Ramuín;1988;1010;978
32;Ourense;053;Oímbra;1720;937;783
32;Ourense;054;Ourense;105643;47891;57752
32;Ourense;055;Paderne de Allariz;1372;679;693
32;Ourense;056;Padrenda;1671;820;851
32;Ourense;057;Parada de Sil;546;292;254
32;Ourense;058;Pereiro de Aguiar, O;6350;3259;3091
32;Ourense;059;Peroxa, A;1810;890;920
32;Ourense;060;Petín;849;421;428
32;Ourense;061;Piñor;1183;606;577
32;Ourense;063;Pobra de Trives, A;2014;1000;1014
32;Ourense;064;Pontedeva;494;238;256
32;Ourense;062;Porqueira;823;385;438
32;Ourense;065;Punxín;708;349;359
32;Ourense;066;Quintela de Leirado;630;282;348
32;Ourense;067;Rairiz de Veiga;1228;627;601
32;Ourense;068;Ramirás;1551;724;827
32;Ourense;069;Ribadavia;5012;2468;2544
32;Ourense;071;Riós;1461;750;711
32;Ourense;072;Rúa, A;4283;2120;2163
32;Ourense;073;Rubiá;1383;672;711
32;Ourense;074;San Amaro;1052;511;541
32;Ourense;075;San Cibrao das Viñas;5395;2728;2667
32;Ourense;076;San Cristovo de Cea;2089;1024;1065
32;Ourense;070;San Xoán de Río;506;259;247
32;Ourense;077;Sandiás;1198;563;635
32;Ourense;078;Sarreaus;1145;570;575
32;Ourense;079;Taboadela;1417;719;698
32;Ourense;080;Teixeira, A;315;158;157
32;Ourense;081;Toén;2353;1209;1144
32;Ourense;082;Trasmiras;1263;631;632
32;Ourense;083;Veiga, A;857;438;419
32;Ourense;084;Verea;912;435;477
32;Ourense;085;Verín;13647;6558;7089
32;Ourense;086;Viana do Bolo;2818;1423;1395
32;Ourense;087;Vilamarín;1852;955;897
32;Ourense;088;Vilamartín de Valdeorras;1812;928;884
32;Ourense;089;Vilar de Barrio;1283;654;629
32;Ourense;090;Vilar de Santos;794;384;410
32;Ourense;091;Vilardevós;1802;940;862
32;Ourense;092;Vilariño de Conso;524;304;220
32;Ourense;032;Xinzo de Limia;9637;4695;4942
32;Ourense;036;Xunqueira de Ambía;1374;695;679
32;Ourense;037;Xunqueira de Espadanedo;751;373;378
34;Palencia;001;Abarca de Campos;45;27;18
34;Palencia;003;Abia de las Torres;170;92;78
34;Palencia;004;Aguilar de Campoo;6749;3262;3487
34;Palencia;005;Alar del Rey;921;446;475
34;Palencia;006;Alba de Cerrato;87;47;40
34;Palencia;009;Amayuelas de Arriba;36;23;13
34;Palencia;010;Ampudia;606;307;299
34;Palencia;011;Amusco;418;235;183
34;Palencia;012;Antigüedad;365;192;173
34;Palencia;015;Arconada;40;25;15
34;Palencia;017;Astudillo;1006;508;498
34;Palencia;018;Autilla del Pino;215;117;98
34;Palencia;019;Autillo de Campos;134;73;61
34;Palencia;020;Ayuela;50;31;19
34;Palencia;022;Baltanás;1206;623;583
34;Palencia;024;Baquerín de Campos;28;16;12
34;Palencia;025;Bárcena de Campos;57;25;32
34;Palencia;027;Barruelo de Santullán;1174;589;585
34;Palencia;028;Báscones de Ojeda;137;71;66
34;Palencia;029;Becerril de Campos;742;383;359
34;Palencia;031;Belmonte de Campos;29;15;14
34;Palencia;032;Berzosilla;42;22;20
34;Palencia;033;Boada de Campos;17;13;4
34;Palencia;035;Boadilla de Rioseco;113;63;50
34;Palencia;034;Boadilla del Camino;121;69;52
34;Palencia;036;Brañosera;258;143;115
34;Palencia;037;Buenavista de Valdavia;304;169;135
34;Palencia;038;Bustillo de la Vega;285;158;127
34;Palencia;039;Bustillo del Páramo de Carrión;62;35;27
34;Palencia;041;Calahorra de Boedo;87;41;46
34;Palencia;042;Calzada de los Molinos;324;181;143
34;Palencia;045;Capillas;73;40;33
34;Palencia;046;Cardeñosa de Volpejera;53;27;26
34;Palencia;047;Carrión de los Condes;2035;965;1070
34;Palencia;048;Castil de Vela;63;29;34
34;Palencia;049;Castrejón de la Peña;344;184;160
34;Palencia;050;Castrillo de Don Juan;195;111;84
34;Palencia;051;Castrillo de Onielo;98;50;48
34;Palencia;052;Castrillo de Villavega;175;97;78
34;Palencia;053;Castromocho;222;113;109
34;Palencia;055;Cervatos de la Cueza;265;144;121
34;Palencia;056;Cervera de Pisuerga;2277;1134;1143
34;Palencia;057;Cevico de la Torre;490;246;244
34;Palencia;058;Cevico Navero;185;109;76
34;Palencia;059;Cisneros;431;213;218
34;Palencia;060;Cobos de Cerrato;138;77;61
34;Palencia;061;Collazos de Boedo;99;58;41
34;Palencia;062;Congosto de Valdavia;151;89;62
34;Palencia;063;Cordovilla la Real;103;60;43
34;Palencia;066;Cubillas de Cerrato;60;36;24
34;Palencia;067;Dehesa de Montejo;127;74;53
34;Palencia;068;Dehesa de Romanos;61;35;26
34;Palencia;069;Dueñas;2624;1335;1289
34;Palencia;070;Espinosa de Cerrato;134;75;59
34;Palencia;071;Espinosa de Villagonzalo;168;90;78
34;Palencia;072;Frechilla;152;72;80
34;Palencia;073;Fresno del Río;186;90;96
34;Palencia;074;Frómista;784;402;382
34;Palencia;076;Fuentes de Nava;636;321;315
34;Palencia;077;Fuentes de Valdepero;466;248;218
34;Palencia;079;Grijota;2362;1231;1131
34;Palencia;080;Guardo;5872;2911;2961
34;Palencia;081;Guaza de Campos;61;38;23
34;Palencia;082;Hérmedes de Cerrato;79;39;40
34;Palencia;083;Herrera de Pisuerga;1914;937;977
34;Palencia;084;Herrera de Valdecañas;156;90;66
34;Palencia;086;Hontoria de Cerrato;104;53;51
34;Palencia;087;Hornillos de Cerrato;143;83;60
34;Palencia;088;Husillos;330;186;144
34;Palencia;089;Itero de la Vega;154;93;61
34;Palencia;091;Lagartos;124;70;54
34;Palencia;092;Lantadilla;280;151;129
34;Palencia;094;Ledigos;66;33;33
34;Palencia;903;Loma de Ucieza;194;113;81
34;Palencia;096;Lomas;49;31;18
34;Palencia;098;Magaz de Pisuerga;1015;533;482
34;Palencia;099;Manquillos;61;35;26
34;Palencia;100;Mantinos;143;80;63
34;Palencia;101;Marcilla de Campos;51;24;27
34;Palencia;102;Mazariegos;212;125;87
34;Palencia;103;Mazuecos de Valdeginate;95;59;36
34;Palencia;104;Melgar de Yuso;248;146;102
34;Palencia;106;Meneses de Campos;121;66;55
34;Palencia;107;Micieces de Ojeda;74;42;32
34;Palencia;108;Monzón de Campos;586;306;280
34;Palencia;109;Moratinos;62;35;27
34;Palencia;110;Mudá;84;45;39
34;Palencia;112;Nogal de las Huertas;41;23;18
34;Palencia;113;Olea de Boedo;41;15;26
34;Palencia;114;Olmos de Ojeda;194;120;74
34;Palencia;116;Osornillo;56;29;27
34;Palencia;901;Osorno la Mayor;1185;625;560
34;Palencia;120;Palencia;78144;36875;41269
34;Palencia;121;Palenzuela;212;121;91
34;Palencia;122;Páramo de Boedo;112;65;47
34;Palencia;123;Paredes de Nava;1892;969;923
34;Palencia;124;Payo de Ojeda;62;38;24
34;Palencia;125;Pedraza de Campos;95;45;50
34;Palencia;126;Pedrosa de la Vega;301;168;133
34;Palencia;127;Perales;92;49;43
34;Palencia;904;Pernía, La;316;184;132
34;Palencia;129;Pino del Río;170;103;67
34;Palencia;130;Piña de Campos;206;106;100
34;Palencia;131;Población de Arroyo;55;29;26
34;Palencia;132;Población de Campos;131;75;56
34;Palencia;133;Población de Cerrato;107;64;43
34;Palencia;134;Polentinos;41;21;20
34;Palencia;135;Pomar de Valdivia;467;257;210
34;Palencia;136;Poza de la Vega;176;102;74
34;Palencia;137;Pozo de Urama;23;16;7
34;Palencia;139;Prádanos de Ojeda;186;100;86
34;Palencia;140;Puebla de Valdavia, La;95;49;46
34;Palencia;141;Quintana del Puente;282;155;127
34;Palencia;143;Quintanilla de Onsoña;181;104;77
34;Palencia;146;Reinoso de Cerrato;54;35;19
34;Palencia;147;Renedo de la Vega;186;102;84
34;Palencia;149;Requena de Campos;22;9;13
34;Palencia;151;Respenda de la Peña;151;91;60
34;Palencia;152;Revenga de Campos;146;74;72
34;Palencia;154;Revilla de Collazos;75;44;31
34;Palencia;155;Ribas de Campos;140;70;70
34;Palencia;156;Riberos de la Cueza;54;33;21
34;Palencia;157;Saldaña;2958;1514;1444
34;Palencia;158;Salinas de Pisuerga;318;166;152
34;Palencia;159;San Cebrián de Campos;420;237;183
34;Palencia;160;San Cebrián de Mudá;154;87;67
34;Palencia;161;San Cristóbal de Boedo;22;14;8
34;Palencia;163;San Mamés de Campos;47;24;23
34;Palencia;165;San Román de la Cuba;61;36;25
34;Palencia;167;Santa Cecilia del Alcor;114;65;49
34;Palencia;168;Santa Cruz de Boedo;49;31;18
34;Palencia;169;Santervás de la Vega;439;250;189
34;Palencia;170;Santibáñez de Ecla;51;29;22
34;Palencia;171;Santibáñez de la Peña;1005;491;514
34;Palencia;174;Santoyo;180;100;80
34;Palencia;175;Serna, La;95;62;33
34;Palencia;177;Soto de Cerrato;192;109;83
34;Palencia;176;Sotobañado y Priorato;139;81;58
34;Palencia;178;Tabanera de Cerrato;133;74;59
34;Palencia;179;Tabanera de Valdavia;26;15;11
34;Palencia;180;Támara de Campos;76;40;36
34;Palencia;181;Tariego de Cerrato;476;254;222
34;Palencia;182;Torquemada;954;523;431
34;Palencia;184;Torremormojón;43;24;19
34;Palencia;185;Triollo;68;38;30
34;Palencia;186;Valbuena de Pisuerga;47;23;24
34;Palencia;189;Valdeolmillos;56;32;24
34;Palencia;190;Valderrábano;50;27;23
34;Palencia;192;Valde-Ucieza;80;48;32
34;Palencia;196;Valle de Cerrato;85;52;33
34;Palencia;902;Valle del Retortillo;160;94;66
34;Palencia;199;Velilla del Río Carrión;1230;626;604
34;Palencia;023;Venta de Baños;6401;3236;3165
34;Palencia;201;Vertavillo;176;96;80
34;Palencia;093;Vid de Ojeda, La;90;55;35
34;Palencia;202;Villabasta de Valdavia;32;18;14
34;Palencia;204;Villacidaler;47;28;19
34;Palencia;205;Villaconancio;62;37;25
34;Palencia;206;Villada;920;470;450
34;Palencia;208;Villaeles de Valdavia;51;30;21
34;Palencia;210;Villahán;98;53;45
34;Palencia;211;Villaherreros;204;104;100
34;Palencia;213;Villalaco;57;34;23
34;Palencia;214;Villalba de Guardo;184;98;86
34;Palencia;215;Villalcázar de Sirga;171;88;83
34;Palencia;216;Villalcón;60;35;25
34;Palencia;217;Villalobón;1734;868;866
34;Palencia;218;Villaluenga de la Vega;574;336;238
34;Palencia;220;Villamartín de Campos;181;99;82
34;Palencia;221;Villamediana;176;98;78
34;Palencia;222;Villameriel;106;59;47
34;Palencia;223;Villamoronta;241;142;99
34;Palencia;224;Villamuera de la Cueza;38;25;13
34;Palencia;225;Villamuriel de Cerrato;6469;3335;3134
34;Palencia;227;Villanueva del Rebollar;72;37;35
34;Palencia;228;Villanuño de Valdavia;89;52;37
34;Palencia;229;Villaprovedo;56;39;17
34;Palencia;230;Villarmentero de Campos;18;12;6
34;Palencia;231;Villarrabé;199;101;98
34;Palencia;232;Villarramiel;818;440;378
34;Palencia;233;Villasarracino;137;84;53
34;Palencia;234;Villasila de Valdavia;70;48;22
34;Palencia;236;Villaturde;157;83;74
34;Palencia;237;Villaumbrales;650;323;327
34;Palencia;238;Villaviudas;345;166;179
34;Palencia;240;Villerías de Campos;82;42;40
34;Palencia;241;Villodre;15;8;7
34;Palencia;242;Villodrigo;110;59;51
34;Palencia;243;Villoldo;343;184;159
34;Palencia;245;Villota del Páramo;332;186;146
34;Palencia;246;Villovieco;74;38;36
35;Palmas, Las;001;Agaete;5599;2800;2799
35;Palmas, Las;002;Agüimes;31914;16120;15794
35;Palmas, Las;020;Aldea de San Nicolás, La;7508;3839;3669
35;Palmas, Las;003;Antigua;12972;6845;6127
35;Palmas, Las;004;Arrecife;64645;32443;32202
35;Palmas, Las;005;Artenara;1049;586;463
35;Palmas, Las;006;Arucas;38334;19077;19257
35;Palmas, Las;007;Betancuria;773;397;376
35;Palmas, Las;008;Firgas;7438;3756;3682
35;Palmas, Las;009;Gáldar;24370;12165;12205
35;Palmas, Las;010;Haría;5263;2713;2550
35;Palmas, Las;011;Ingenio;31694;15901;15793
35;Palmas, Las;012;Mogán;20487;10579;9908
35;Palmas, Las;013;Moya;7746;3939;3807
35;Palmas, Las;014;Oliva, La;27234;14140;13094
35;Palmas, Las;015;Pájara;21349;11118;10231
35;Palmas, Las;016;Palmas de Gran Canaria, Las;381223;183905;197318
35;Palmas, Las;017;Puerto del Rosario;41808;21145;20663
35;Palmas, Las;018;San Bartolomé;19099;9556;9543
35;Palmas, Las;019;San Bartolomé de Tirajana;53397;27857;25540
35;Palmas, Las;021;Santa Brígida;18394;9139;9255
35;Palmas, Las;022;Santa Lucía de Tirajana;74602;37222;37380
35;Palmas, Las;023;Santa María de Guía de Gran Canaria;13897;6914;6983
35;Palmas, Las;024;Teguise;22703;11428;11275
35;Palmas, Las;025;Tejeda;1883;1016;867
35;Palmas, Las;026;Telde;102791;50425;52366
35;Palmas, Las;027;Teror;12522;6410;6112
35;Palmas, Las;028;Tías;20628;10607;10021
35;Palmas, Las;029;Tinajo;6434;3324;3110
35;Palmas, Las;030;Tuineje;15596;7972;7624
35;Palmas, Las;032;Valleseco;3727;1957;1770
35;Palmas, Las;031;Valsequillo de Gran Canaria;9377;4704;4673
35;Palmas, Las;033;Vega de San Mateo;7569;3900;3669
35;Palmas, Las;034;Yaiza;17040;8795;8245
36;Pontevedra;020;Agolada;2304;1153;1151
36;Pontevedra;001;Arbo;2576;1335;1241
36;Pontevedra;003;Baiona;12129;5977;6152
36;Pontevedra;002;Barro;3623;1784;1839
36;Pontevedra;004;Bueu;11950;5878;6072
36;Pontevedra;005;Caldas de Reis;9775;4699;5076
36;Pontevedra;006;Cambados;13721;6630;7091
36;Pontevedra;007;Campo Lameiro;1778;841;937
36;Pontevedra;008;Cangas;26582;13195;13387
36;Pontevedra;009;Cañiza, A;5122;2510;2612
36;Pontevedra;010;Catoira;3331;1615;1716
36;Pontevedra;902;Cerdedo-Cotobade;5697;2771;2926
36;Pontevedra;013;Covelo;2368;1198;1170
36;Pontevedra;014;Crecente;1994;973;1021
36;Pontevedra;015;Cuntis;4665;2215;2450
36;Pontevedra;016;Dozón;1073;560;513
36;Pontevedra;017;Estrada, A;20351;9771;10580
36;Pontevedra;018;Forcarei;3308;1569;1739
36;Pontevedra;019;Fornelos de Montes;1598;768;830
36;Pontevedra;021;Gondomar;14702;7303;7399
36;Pontevedra;022;Grove, O;10518;5178;5340
36;Pontevedra;023;Guarda, A;10025;4901;5124
36;Pontevedra;901;Illa de Arousa, A;4932;2449;2483
36;Pontevedra;024;Lalín;20207;9864;10343
36;Pontevedra;025;Lama, A;2397;1192;1205
36;Pontevedra;026;Marín;24242;12060;12182
36;Pontevedra;027;Meaño;5322;2593;2729
36;Pontevedra;028;Meis;4754;2270;2484
36;Pontevedra;029;Moaña;19452;9455;9997
36;Pontevedra;030;Mondariz;4410;2185;2225
36;Pontevedra;031;Mondariz-Balneario;637;324;313
36;Pontevedra;032;Moraña;4147;2012;2135
36;Pontevedra;033;Mos;15063;7428;7635
36;Pontevedra;034;Neves, As;3803;1838;1965
36;Pontevedra;035;Nigrán;17745;8710;9035
36;Pontevedra;036;Oia;3049;1510;1539
36;Pontevedra;037;Pazos de Borbén;2965;1455;1510
36;Pontevedra;041;Poio;17073;8462;8611
36;Pontevedra;043;Ponte Caldelas;5533;2670;2863
36;Pontevedra;042;Ponteareas;22940;11121;11819
36;Pontevedra;044;Pontecesures;3053;1504;1549
36;Pontevedra;038;Pontevedra;83260;39344;43916
36;Pontevedra;039;Porriño, O;20100;9910;10190
36;Pontevedra;040;Portas;2906;1410;1496
36;Pontevedra;045;Redondela;29241;14202;15039
36;Pontevedra;046;Ribadumia;5105;2484;2621
36;Pontevedra;047;Rodeiro;2393;1214;1179
36;Pontevedra;048;Rosal, O;6289;3092;3197
36;Pontevedra;049;Salceda de Caselas;9173;4580;4593
36;Pontevedra;050;Salvaterra de Miño;9990;4999;4991
36;Pontevedra;051;Sanxenxo;17414;8608;8806
36;Pontevedra;052;Silleda;8861;4296;4565
36;Pontevedra;053;Soutomaior;7426;3702;3724
36;Pontevedra;054;Tomiño;13566;6827;6739
36;Pontevedra;055;Tui;17323;8409;8914
36;Pontevedra;056;Valga;5824;2866;2958
36;Pontevedra;057;Vigo;296692;140164;156528
36;Pontevedra;059;Vila de Cruces;5208;2578;2630
36;Pontevedra;058;Vilaboa;5919;2892;3027
36;Pontevedra;060;Vilagarcía de Arousa;37565;17989;19576
36;Pontevedra;061;Vilanova de Arousa;10239;4960;5279
26;Rioja, La;001;Ábalos;255;150;105
26;Rioja, La;002;Agoncillo;1096;605;491
26;Rioja, La;003;Aguilar del Río Alhama;459;242;217
26;Rioja, La;004;Ajamil de Cameros;68;46;22
26;Rioja, La;005;Albelda de Iregua;3481;1774;1707
26;Rioja, La;006;Alberite;2457;1249;1208
26;Rioja, La;007;Alcanadre;638;337;301
26;Rioja, La;008;Aldeanueva de Ebro;2760;1429;1331
26;Rioja, La;009;Alesanco;504;261;243
26;Rioja, La;010;Alesón;94;56;38
26;Rioja, La;011;Alfaro;9611;4831;4780
26;Rioja, La;012;Almarza de Cameros;32;21;11
26;Rioja, La;013;Anguciana;425;229;196
26;Rioja, La;014;Anguiano;494;276;218
26;Rioja, La;015;Arenzana de Abajo;237;121;116
26;Rioja, La;016;Arenzana de Arriba;29;20;9
26;Rioja, La;017;Arnedillo;448;218;230
26;Rioja, La;018;Arnedo;15015;7497;7518
26;Rioja, La;019;Arrúbal;516;268;248
26;Rioja, La;020;Ausejo;808;429;379
26;Rioja, La;021;Autol;4623;2292;2331
26;Rioja, La;022;Azofra;219;124;95
26;Rioja, La;023;Badarán;477;245;232
26;Rioja, La;024;Bañares;230;125;105
26;Rioja, La;026;Baños de Río Tobía;1585;795;790
26;Rioja, La;025;Baños de Rioja;83;48;35
26;Rioja, La;027;Berceo;151;93;58
26;Rioja, La;028;Bergasa;148;82;66
26;Rioja, La;029;Bergasillas Bajera;35;17;18
26;Rioja, La;030;Bezares;22;10;12
26;Rioja, La;031;Bobadilla;96;49;47
26;Rioja, La;032;Brieva de Cameros;38;25;13
26;Rioja, La;033;Briñas;190;88;102
26;Rioja, La;034;Briones;749;394;355
26;Rioja, La;035;Cabezón de Cameros;14;10;4
26;Rioja, La;036;Calahorra;24531;12042;12489
26;Rioja, La;037;Camprovín;165;89;76
26;Rioja, La;038;Canales de la Sierra;86;55;31
26;Rioja, La;039;Canillas de Río Tuerto;43;23;20
26;Rioja, La;040;Cañas;93;48;45
26;Rioja, La;041;Cárdenas;124;66;58
26;Rioja, La;042;Casalarreina;1102;550;552
26;Rioja, La;043;Castañares de Rioja;404;190;214
26;Rioja, La;044;Castroviejo;47;28;19
26;Rioja, La;045;Cellorigo;11;4;7
26;Rioja, La;046;Cenicero;2086;1067;1019
26;Rioja, La;047;Cervera del Río Alhama;2308;1197;1111
26;Rioja, La;048;Cidamón;24;12;12
26;Rioja, La;049;Cihuri;177;94;83
26;Rioja, La;050;Cirueña;168;110;58
26;Rioja, La;051;Clavijo;269;162;107
26;Rioja, La;052;Cordovín;153;76;77
26;Rioja, La;053;Corera;256;133;123
26;Rioja, La;054;Cornago;317;185;132
26;Rioja, La;055;Corporales;39;24;15
26;Rioja, La;056;Cuzcurrita de Río Tirón;509;276;233
26;Rioja, La;057;Daroca de Rioja;50;34;16
26;Rioja, La;058;Enciso;170;109;61
26;Rioja, La;059;Entrena;1545;812;733
26;Rioja, La;060;Estollo;86;54;32
26;Rioja, La;061;Ezcaray;2045;1068;977
26;Rioja, La;062;Foncea;94;55;39
26;Rioja, La;063;Fonzaleche;134;90;44
26;Rioja, La;064;Fuenmayor;3143;1600;1543
26;Rioja, La;065;Galbárruli;67;44;23
26;Rioja, La;066;Galilea;366;185;181
26;Rioja, La;067;Gallinero de Cameros;20;13;7
26;Rioja, La;068;Gimileo;111;60;51
26;Rioja, La;069;Grañón;247;141;106
26;Rioja, La;070;Grávalos;187;102;85
26;Rioja, La;071;Haro;11557;5699;5858
26;Rioja, La;072;Herce;330;169;161
26;Rioja, La;073;Herramélluri;111;60;51
26;Rioja, La;074;Hervías;126;66;60
26;Rioja, La;075;Hormilla;418;225;193
26;Rioja, La;076;Hormilleja;134;64;70
26;Rioja, La;077;Hornillos de Cameros;16;8;8
26;Rioja, La;078;Hornos de Moncalvillo;94;58;36
26;Rioja, La;079;Huércanos;846;468;378
26;Rioja, La;080;Igea;603;341;262
26;Rioja, La;081;Jalón de Cameros;21;10;11
26;Rioja, La;082;Laguna de Cameros;106;65;41
26;Rioja, La;083;Lagunilla del Jubera;343;190;153
26;Rioja, La;084;Lardero;10813;5419;5394
26;Rioja, La;086;Ledesma de la Cogolla;16;12;4
26;Rioja, La;087;Leiva;236;120;116
26;Rioja, La;088;Leza de Río Leza;41;24;17
26;Rioja, La;089;Logroño;152485;72341;80144
26;Rioja, La;091;Lumbreras;152;104;48
26;Rioja, La;092;Manjarrés;119;72;47
26;Rioja, La;093;Mansilla de la Sierra;56;41;15
26;Rioja, La;094;Manzanares de Rioja;65;39;26
26;Rioja, La;095;Matute;91;53;38
26;Rioja, La;096;Medrano;325;173;152
26;Rioja, La;098;Munilla;102;56;46
26;Rioja, La;099;Murillo de Río Leza;1652;845;807
26;Rioja, La;100;Muro de Aguas;61;36;25
26;Rioja, La;101;Muro en Cameros;35;19;16
26;Rioja, La;102;Nájera;8072;3964;4108
26;Rioja, La;103;Nalda;1057;582;475
26;Rioja, La;104;Navajún;10;8;2
26;Rioja, La;105;Navarrete;2935;1482;1453
26;Rioja, La;106;Nestares;80;43;37
26;Rioja, La;107;Nieva de Cameros;83;56;27
26;Rioja, La;109;Ochánduri;71;45;26
26;Rioja, La;108;Ocón;317;194;123
26;Rioja, La;110;Ojacastro;182;109;73
26;Rioja, La;111;Ollauri;286;153;133
26;Rioja, La;112;Ortigosa de Cameros;221;134;87
26;Rioja, La;113;Pazuengos;26;20;6
26;Rioja, La;114;Pedroso;73;51;22
26;Rioja, La;115;Pinillos;19;10;9
26;Rioja, La;117;Pradejón;3910;2030;1880
26;Rioja, La;118;Pradillo;69;37;32
26;Rioja, La;119;Préjano;206;110;96
26;Rioja, La;120;Quel;2078;1106;972
26;Rioja, La;121;Rabanera;32;22;10
26;Rioja, La;122;Rasillo de Cameros, El;145;80;65
26;Rioja, La;123;Redal, El;152;84;68
26;Rioja, La;124;Ribafrecha;958;500;458
26;Rioja, La;125;Rincón de Soto;3886;1989;1897
26;Rioja, La;126;Robres del Castillo;29;19;10
26;Rioja, La;127;Rodezno;228;126;102
26;Rioja, La;128;Sajazarra;129;68;61
26;Rioja, La;129;San Asensio;1108;592;516
26;Rioja, La;130;San Millán de la Cogolla;229;152;77
26;Rioja, La;131;San Millán de Yécora;34;24;10
26;Rioja, La;132;San Román de Cameros;125;79;46
26;Rioja, La;139;San Torcuato;68;35;33
26;Rioja, La;142;San Vicente de la Sonsierra;996;518;478
26;Rioja, La;134;Santa Coloma;91;54;37
26;Rioja, La;135;Santa Engracia del Jubera;160;103;57
26;Rioja, La;136;Santa Eulalia Bajera;105;60;45
26;Rioja, La;138;Santo Domingo de la Calzada;6276;3128;3148
26;Rioja, La;140;Santurde de Rioja;275;148;127
26;Rioja, La;141;Santurdejo;102;64;38
26;Rioja, La;143;Sojuela;347;192;155
26;Rioja, La;144;Sorzano;225;126;99
26;Rioja, La;145;Sotés;284;157;127
26;Rioja, La;146;Soto en Cameros;80;48;32
26;Rioja, La;147;Terroba;34;19;15
26;Rioja, La;148;Tirgo;185;92;93
26;Rioja, La;149;Tobía;43;24;19
26;Rioja, La;150;Tormantos;117;69;48
26;Rioja, La;153;Torre en Cameros;10;8;2
26;Rioja, La;151;Torrecilla en Cameros;453;253;200
26;Rioja, La;152;Torrecilla sobre Alesanco;34;23;11
26;Rioja, La;154;Torremontalbo;10;7;3
26;Rioja, La;155;Treviana;150;81;69
26;Rioja, La;157;Tricio;374;186;188
26;Rioja, La;158;Tudelilla;341;186;155
26;Rioja, La;160;Uruñuela;967;487;480
26;Rioja, La;161;Valdemadera;8;5;3
26;Rioja, La;162;Valgañón;130;80;50
26;Rioja, La;163;Ventosa;161;83;78
26;Rioja, La;164;Ventrosa;48;30;18
26;Rioja, La;165;Viguera;382;220;162
26;Rioja, La;166;Villalba de Rioja;158;96;62
26;Rioja, La;167;Villalobar de Rioja;55;41;14
26;Rioja, La;168;Villamediana de Iregua;8359;4216;4143
26;Rioja, La;169;Villanueva de Cameros;71;39;32
26;Rioja, La;170;Villar de Arnedo, El;596;308;288
26;Rioja, La;171;Villar de Torre;160;100;60
26;Rioja, La;172;Villarejo;26;21;5
26;Rioja, La;173;Villarroya;5;3;2
26;Rioja, La;174;Villarta-Quintana;142;83;59
26;Rioja, La;175;Villavelayo;45;29;16
26;Rioja, La;176;Villaverde de Rioja;56;33;23
26;Rioja, La;177;Villoslada de Cameros;327;210;117
26;Rioja, La;178;Viniegra de Abajo;75;48;27
26;Rioja, La;179;Viniegra de Arriba;36;25;11
26;Rioja, La;180;Zarratón;274;145;129
26;Rioja, La;181;Zarzosa;15;10;5
26;Rioja, La;183;Zorraquín;90;42;48
37;Salamanca;001;Abusejo;175;93;82
37;Salamanca;002;Agallas;132;69;63
37;Salamanca;003;Ahigal de los Aceiteros;113;61;52
37;Salamanca;004;Ahigal de Villarino;29;16;13
37;Salamanca;005;Alameda de Gardón, La;68;35;33
37;Salamanca;006;Alamedilla, La;118;57;61
37;Salamanca;007;Alaraz;425;224;201
37;Salamanca;008;Alba de Tormes;5166;2590;2576
37;Salamanca;009;Alba de Yeltes;214;117;97
37;Salamanca;010;Alberca, La;1071;524;547
37;Salamanca;011;Alberguería de Argañán, La;106;54;52
37;Salamanca;012;Alconada;152;81;71
37;Salamanca;015;Aldea del Obispo;246;127;119
37;Salamanca;013;Aldeacipreste;106;55;51
37;Salamanca;014;Aldeadávila de la Ribera;1209;605;604
37;Salamanca;016;Aldealengua;666;329;337
37;Salamanca;017;Aldeanueva de Figueroa;250;136;114
37;Salamanca;018;Aldeanueva de la Sierra;109;67;42
37;Salamanca;019;Aldearrodrigo;139;75;64
37;Salamanca;020;Aldearrubia;495;269;226
37;Salamanca;021;Aldeaseca de Alba;74;38;36
37;Salamanca;022;Aldeaseca de la Frontera;257;136;121
37;Salamanca;023;Aldeatejada;2210;1113;1097
37;Salamanca;024;Aldeavieja de Tormes;100;55;45
37;Salamanca;025;Aldehuela de la Bóveda;273;147;126
37;Salamanca;026;Aldehuela de Yeltes;190;103;87
37;Salamanca;027;Almenara de Tormes;287;158;129
37;Salamanca;028;Almendra;142;84;58
37;Salamanca;029;Anaya de Alba;189;112;77
37;Salamanca;030;Añover de Tormes;89;46;43
37;Salamanca;031;Arabayona de Mógica;343;192;151
37;Salamanca;032;Arapiles;651;352;299
37;Salamanca;033;Arcediano;95;48;47
37;Salamanca;034;Arco, El;88;44;44
37;Salamanca;035;Armenteros;194;107;87
37;Salamanca;037;Atalaya, La;108;60;48
37;Salamanca;038;Babilafuente;917;476;441
37;Salamanca;039;Bañobárez;291;149;142
37;Salamanca;040;Barbadillo;388;210;178
37;Salamanca;041;Barbalos;70;39;31
37;Salamanca;042;Barceo;43;26;17
37;Salamanca;044;Barruecopardo;448;251;197
37;Salamanca;045;Bastida, La;25;15;10
37;Salamanca;046;Béjar;12559;5930;6629
37;Salamanca;047;Beleña;244;120;124
37;Salamanca;049;Bermellar;124;63;61
37;Salamanca;050;Berrocal de Huebra;68;39;29
37;Salamanca;051;Berrocal de Salvatierra;83;43;40
37;Salamanca;052;Boada;306;151;155
37;Salamanca;054;Bodón, El;258;141;117
37;Salamanca;055;Bogajo;133;72;61
37;Salamanca;056;Bouza, La;55;24;31
37;Salamanca;057;Bóveda del Río Almar;225;123;102
37;Salamanca;058;Brincones;55;28;27
37;Salamanca;059;Buenamadre;124;66;58
37;Salamanca;060;Buenavista;350;190;160
37;Salamanca;061;Cabaco, El;205;111;94
37;Salamanca;063;Cabeza de Béjar, La;60;37;23
37;Salamanca;065;Cabeza del Caballo;279;153;126
37;Salamanca;062;Cabezabellosa de la Calzada;78;46;32
37;Salamanca;067;Cabrerizos;4254;2103;2151
37;Salamanca;068;Cabrillas;371;190;181
37;Salamanca;069;Calvarrasa de Abajo;1166;628;538
37;Salamanca;070;Calvarrasa de Arriba;573;311;262
37;Salamanca;071;Calzada de Béjar, La;91;50;41
37;Salamanca;072;Calzada de Don Diego;153;83;70
37;Salamanca;073;Calzada de Valdunciel;690;338;352
37;Salamanca;074;Campillo de Azaba;155;91;64
37;Salamanca;077;Campo de Peñaranda, El;256;151;105
37;Salamanca;078;Candelario;860;441;419
37;Salamanca;079;Canillas de Abajo;77;54;23
37;Salamanca;080;Cantagallo;265;140;125
37;Salamanca;081;Cantalapiedra;950;491;459
37;Salamanca;082;Cantalpino;833;450;383
37;Salamanca;083;Cantaracillo;191;104;87
37;Salamanca;085;Carbajosa de la Sagrada;7251;3623;3628
37;Salamanca;086;Carpio de Azaba;113;64;49
37;Salamanca;087;Carrascal de Barregas;1231;639;592
37;Salamanca;088;Carrascal del Obispo;206;110;96
37;Salamanca;089;Casafranca;64;34;30
37;Salamanca;090;Casas del Conde, Las;59;26;33
37;Salamanca;091;Casillas de Flores;184;90;94
37;Salamanca;092;Castellanos de Moriscos;2724;1409;1315
37;Salamanca;185;Castellanos de Villiquera;628;343;285
37;Salamanca;096;Castillejo de Martín Viejo;211;129;82
37;Salamanca;097;Castraz;41;27;14
37;Salamanca;098;Cepeda;293;149;144
37;Salamanca;099;Cereceda de la Sierra;66;35;31
37;Salamanca;100;Cerezal de Peñahorcada;71;36;35
37;Salamanca;101;Cerralbo;139;78;61
37;Salamanca;102;Cerro, El;399;204;195
37;Salamanca;103;Cespedosa de Tormes;488;266;222
37;Salamanca;114;Chagarcía Medianero;73;41;32
37;Salamanca;104;Cilleros de la Bastida;21;10;11
37;Salamanca;106;Cipérez;261;138;123
37;Salamanca;107;Ciudad Rodrigo;12261;5893;6368
37;Salamanca;108;Coca de Alba;104;51;53
37;Salamanca;109;Colmenar de Montemayor;186;108;78
37;Salamanca;110;Cordovilla;112;59;53
37;Salamanca;112;Cristóbal;158;92;66
37;Salamanca;113;Cubo de Don Sancho, El;432;226;206
37;Salamanca;115;Dios le Guarde;114;64;50
37;Salamanca;116;Doñinos de Ledesma;68;34;34
37;Salamanca;117;Doñinos de Salamanca;2172;1132;1040
37;Salamanca;118;Éjeme;124;71;53
37;Salamanca;120;Encina de San Silvestre;111;55;56
37;Salamanca;119;Encina, La;104;61;43
37;Salamanca;121;Encinas de Abajo;605;324;281
37;Salamanca;122;Encinas de Arriba;235;120;115
37;Salamanca;123;Encinasola de los Comendadores;160;89;71
37;Salamanca;124;Endrinal;210;115;95
37;Salamanca;125;Escurial de la Sierra;241;130;111
37;Salamanca;126;Espadaña;32;19;13
37;Salamanca;127;Espeja;225;115;110
37;Salamanca;128;Espino de la Orbada;250;137;113
37;Salamanca;129;Florida de Liébana;251;134;117
37;Salamanca;130;Forfoleda;190;104;86
37;Salamanca;131;Frades de la Sierra;177;100;77
37;Salamanca;132;Fregeneda, La;329;163;166
37;Salamanca;133;Fresnedoso;104;59;45
37;Salamanca;134;Fresno Alhándiga;205;113;92
37;Salamanca;135;Fuente de San Esteban, La;1285;655;630
37;Salamanca;136;Fuenteguinaldo;678;334;344
37;Salamanca;137;Fuenteliante;94;49;45
37;Salamanca;138;Fuenterroble de Salvatierra;270;136;134
37;Salamanca;139;Fuentes de Béjar;212;104;108
37;Salamanca;140;Fuentes de Oñoro;1136;612;524
37;Salamanca;141;Gajates;157;75;82
37;Salamanca;142;Galindo y Perahuy;653;376;277
37;Salamanca;143;Galinduste;428;206;222
37;Salamanca;144;Galisancho;361;194;167
37;Salamanca;145;Gallegos de Argañán;264;133;131
37;Salamanca;146;Gallegos de Solmirón;112;64;48
37;Salamanca;147;Garcibuey;191;110;81
37;Salamanca;148;Garcihernández;437;228;209
37;Salamanca;149;Garcirrey;62;37;25
37;Salamanca;150;Gejuelo del Barro;35;20;15
37;Salamanca;151;Golpejas;155;77;78
37;Salamanca;152;Gomecello;430;229;201
37;Salamanca;154;Guadramiro;137;84;53
37;Salamanca;155;Guijo de Ávila;75;42;33
37;Salamanca;156;Guijuelo;5616;2809;2807
37;Salamanca;157;Herguijuela de Ciudad Rodrigo;70;42;28
37;Salamanca;158;Herguijuela de la Sierra;244;135;109
37;Salamanca;159;Herguijuela del Campo;74;40;34
37;Salamanca;160;Hinojosa de Duero;636;318;318
37;Salamanca;161;Horcajo de Montemayor;129;69;60
37;Salamanca;162;Horcajo Medianero;221;116;105
37;Salamanca;163;Hoya, La;37;21;16
37;Salamanca;164;Huerta;288;162;126
37;Salamanca;165;Iruelos;33;16;17
37;Salamanca;166;Ituero de Azaba;210;110;100
37;Salamanca;167;Juzbado;198;102;96
37;Salamanca;168;Lagunilla;441;239;202
37;Salamanca;169;Larrodrigo;182;106;76
37;Salamanca;170;Ledesma;1547;763;784
37;Salamanca;171;Ledrada;477;242;235
37;Salamanca;172;Linares de Riofrío;944;516;428
37;Salamanca;173;Lumbrales;1571;788;783
37;Salamanca;175;Machacón;446;231;215
37;Salamanca;174;Macotera;1019;521;498
37;Salamanca;176;Madroñal;142;78;64
37;Salamanca;177;Maíllo, El;245;138;107
37;Salamanca;178;Malpartida;96;51;45
37;Salamanca;179;Mancera de Abajo;205;109;96
37;Salamanca;180;Manzano, El;70;36;34
37;Salamanca;181;Martiago;263;143;120
37;Salamanca;183;Martín de Yeltes;407;212;195
37;Salamanca;182;Martinamor;79;51;28
37;Salamanca;184;Masueco;285;146;139
37;Salamanca;186;Mata de Ledesma, La;92;52;40
37;Salamanca;187;Matilla de los Caños del Río;623;311;312
37;Salamanca;188;Maya, La;163;96;67
37;Salamanca;189;Membribe de la Sierra;112;67;45
37;Salamanca;190;Mieza;198;102;96
37;Salamanca;191;Milano, El;101;60;41
37;Salamanca;192;Miranda de Azán;440;231;209
37;Salamanca;193;Miranda del Castañar;385;208;177
37;Salamanca;194;Mogarraz;268;136;132
37;Salamanca;195;Molinillo;39;23;16
37;Salamanca;196;Monforte de la Sierra;65;34;31
37;Salamanca;197;Monleón;93;53;40
37;Salamanca;198;Monleras;226;108;118
37;Salamanca;199;Monsagro;138;78;60
37;Salamanca;200;Montejo;205;118;87
37;Salamanca;201;Montemayor del Río;263;140;123
37;Salamanca;202;Monterrubio de Armuña;1326;696;630
37;Salamanca;203;Monterrubio de la Sierra;151;83;68
37;Salamanca;204;Morasverdes;252;132;120
37;Salamanca;205;Morille;226;124;102
37;Salamanca;206;Moríñigo;96;53;43
37;Salamanca;207;Moriscos;459;255;204
37;Salamanca;208;Moronta;72;46;26
37;Salamanca;209;Mozárbez;507;269;238
37;Salamanca;211;Narros de Matalayegua;212;117;95
37;Salamanca;213;Nava de Béjar;86;51;35
37;Salamanca;214;Nava de Francia;123;64;59
37;Salamanca;215;Nava de Sotrobal;155;89;66
37;Salamanca;212;Navacarros;119;64;55
37;Salamanca;216;Navales;317;170;147
37;Salamanca;217;Navalmoral de Béjar;59;27;32
37;Salamanca;218;Navamorales;52;32;20
37;Salamanca;219;Navarredonda de la Rinconada;168;85;83
37;Salamanca;221;Navasfrías;422;223;199
37;Salamanca;222;Negrilla de Palencia;83;50;33
37;Salamanca;223;Olmedo de Camaces;113;59;54
37;Salamanca;224;Orbada, La;197;103;94
37;Salamanca;225;Pajares de la Laguna;106;57;49
37;Salamanca;226;Palacios del Arzobispo;168;82;86
37;Salamanca;228;Palaciosrubios;333;176;157
37;Salamanca;229;Palencia de Negrilla;155;93;62
37;Salamanca;230;Parada de Arriba;252;130;122
37;Salamanca;231;Parada de Rubiales;247;134;113
37;Salamanca;232;Paradinas de San Juan;383;226;157
37;Salamanca;233;Pastores;56;36;20
37;Salamanca;234;Payo, El;324;159;165
37;Salamanca;235;Pedraza de Alba;231;124;107
37;Salamanca;236;Pedrosillo de Alba;132;80;52
37;Salamanca;237;Pedrosillo de los Aires;346;196;150
37;Salamanca;238;Pedrosillo el Ralo;131;68;63
37;Salamanca;239;Pedroso de la Armuña, El;210;111;99
37;Salamanca;240;Pelabravo;1210;646;564
37;Salamanca;241;Pelarrodríguez;172;103;69
37;Salamanca;242;Pelayos;81;49;32
37;Salamanca;243;Peña, La;88;43;45
37;Salamanca;244;Peñacaballera;141;72;69
37;Salamanca;245;Peñaparda;344;171;173
37;Salamanca;246;Peñaranda de Bracamonte;6161;3031;3130
37;Salamanca;247;Peñarandilla;181;99;82
37;Salamanca;248;Peralejos de Abajo;163;86;77
37;Salamanca;249;Peralejos de Arriba;36;23;13
37;Salamanca;250;Pereña de la Ribera;332;179;153
37;Salamanca;251;Peromingo;117;56;61
37;Salamanca;252;Pinedas;105;60;45
37;Salamanca;253;Pino de Tormes, El;157;85;72
37;Salamanca;254;Pitiegua;187;105;82
37;Salamanca;255;Pizarral;49;32;17
37;Salamanca;256;Poveda de las Cintas;199;115;84
37;Salamanca;257;Pozos de Hinojo;52;28;24
37;Salamanca;258;Puebla de Azaba;154;88;66
37;Salamanca;259;Puebla de San Medel;37;22;15
37;Salamanca;260;Puebla de Yeltes;148;78;70
37;Salamanca;261;Puente del Congosto;221;125;96
37;Salamanca;262;Puertas;79;44;35
37;Salamanca;263;Puerto de Béjar;373;177;196
37;Salamanca;264;Puerto Seguro;59;28;31
37;Salamanca;265;Rágama;213;109;104
37;Salamanca;266;Redonda, La;71;41;30
37;Salamanca;267;Retortillo;186;100;86
37;Salamanca;268;Rinconada de la Sierra, La;105;62;43
37;Salamanca;269;Robleda;471;261;210
37;Salamanca;270;Robliza de Cojos;202;105;97
37;Salamanca;271;Rollán;364;202;162
37;Salamanca;272;Saelices el Chico;151;89;62
37;Salamanca;273;Sagrada, La;94;55;39
37;Salamanca;303;Sahugo, El;183;100;83
37;Salamanca;274;Salamanca;144825;65661;79164
37;Salamanca;275;Saldeana;99;57;42
37;Salamanca;276;Salmoral;125;74;51
37;Salamanca;277;Salvatierra de Tormes;74;37;37
37;Salamanca;278;San Cristóbal de la Cuesta;1031;540;491
37;Salamanca;284;San Esteban de la Sierra;345;197;148
37;Salamanca;285;San Felices de los Gallegos;377;198;179
37;Salamanca;286;San Martín del Castañar;225;120;105
37;Salamanca;287;San Miguel de Valero;318;163;155
37;Salamanca;036;San Miguel del Robledo;52;31;21
37;Salamanca;288;San Morales;345;189;156
37;Salamanca;289;San Muñoz;216;109;107
37;Salamanca;291;San Pedro de Rozados;281;159;122
37;Salamanca;290;San Pedro del Valle;142;81;61
37;Salamanca;292;San Pelayo de Guareña;91;53;38
37;Salamanca;280;Sanchón de la Ribera;76;40;36
37;Salamanca;281;Sanchón de la Sagrada;39;23;16
37;Salamanca;282;Sanchotello;227;116;111
37;Salamanca;279;Sancti-Spíritus;782;424;358
37;Salamanca;283;Sando;124;71;53
37;Salamanca;293;Santa María de Sando;100;53;47
37;Salamanca;294;Santa Marta de Tormes;14730;7218;7512
37;Salamanca;296;Santiago de la Puebla;309;158;151
37;Salamanca;297;Santibáñez de Béjar;456;231;225
37;Salamanca;298;Santibáñez de la Sierra;173;100;73
37;Salamanca;299;Santiz;253;135;118
37;Salamanca;300;Santos, Los;605;312;293
37;Salamanca;301;Sardón de los Frailes;94;54;40
37;Salamanca;302;Saucelle;280;139;141
37;Salamanca;304;Sepulcro-Hilario;164;92;72
37;Salamanca;305;Sequeros;232;116;116
37;Salamanca;306;Serradilla del Arroyo;251;138;113
37;Salamanca;307;Serradilla del Llano;153;79;74
37;Salamanca;309;Sierpe, La;40;21;19
37;Salamanca;310;Sieteiglesias de Tormes;193;93;100
37;Salamanca;311;Sobradillo;203;103;100
37;Salamanca;312;Sorihuela;253;135;118
37;Salamanca;313;Sotoserrano;557;297;260
37;Salamanca;314;Tabera de Abajo;103;57;46
37;Salamanca;315;Tala, La;84;46;38
37;Salamanca;316;Tamames;784;397;387
37;Salamanca;317;Tarazona de Guareña;302;163;139
37;Salamanca;318;Tardáguila;201;122;79
37;Salamanca;319;Tejado, El;86;46;40
37;Salamanca;320;Tejeda y Segoyuela;89;49;40
37;Salamanca;321;Tenebrón;137;72;65
37;Salamanca;322;Terradillos;3041;1518;1523
37;Salamanca;323;Topas;521;282;239
37;Salamanca;324;Tordillos;340;185;155
37;Salamanca;325;Tornadizo, El;94;53;41
37;Salamanca;327;Torresmenudas;187;96;91
37;Salamanca;328;Trabanca;177;84;93
37;Salamanca;329;Tremedal de Tormes;41;22;19
37;Salamanca;330;Valdecarros;337;173;164
37;Salamanca;331;Valdefuentes de Sangusín;189;108;81
37;Salamanca;332;Valdehijaderos;73;39;34
37;Salamanca;333;Valdelacasa;216;124;92
37;Salamanca;334;Valdelageve;67;37;30
37;Salamanca;335;Valdelosa;406;205;201
37;Salamanca;336;Valdemierque;64;41;23
37;Salamanca;337;Valderrodrigo;144;76;68
37;Salamanca;338;Valdunciel;95;46;49
37;Salamanca;339;Valero;302;170;132
37;Salamanca;343;Vallejera de Riofrío;72;35;37
37;Salamanca;340;Valsalabroso;141;79;62
37;Salamanca;341;Valverde de Valdelacasa;65;33;32
37;Salamanca;342;Valverdón;280;147;133
37;Salamanca;344;Vecinos;242;120;122
37;Salamanca;345;Vega de Tirados;170;94;76
37;Salamanca;346;Veguillas, Las;283;139;144
37;Salamanca;347;Vellés, La;522;288;234
37;Salamanca;348;Ventosa del Río Almar;105;58;47
37;Salamanca;349;Vídola, La;104;52;52
37;Salamanca;351;Villaflores;271;138;133
37;Salamanca;352;Villagonzalo de Tormes;227;131;96
37;Salamanca;353;Villalba de los Llanos;129;72;57
37;Salamanca;354;Villamayor;7212;3625;3587
37;Salamanca;355;Villanueva del Conde;163;81;82
37;Salamanca;356;Villar de Argañán;91;51;40
37;Salamanca;357;Villar de Ciervo;264;139;125
37;Salamanca;358;Villar de Gallimazo;202;130;72
37;Salamanca;359;Villar de la Yegua;174;91;83
37;Salamanca;360;Villar de Peralonso;217;113;104
37;Salamanca;361;Villar de Samaniego;88;49;39
37;Salamanca;362;Villares de la Reina;6369;3158;3211
37;Salamanca;363;Villares de Yeltes;109;49;60
37;Salamanca;364;Villarino de los Aires;792;416;376
37;Salamanca;365;Villarmayor;178;101;77
37;Salamanca;366;Villarmuerto;39;27;12
37;Salamanca;367;Villasbuenas;183;100;83
37;Salamanca;368;Villasdardo;22;6;16
37;Salamanca;369;Villaseco de los Gamitos;136;78;58
37;Salamanca;370;Villaseco de los Reyes;331;191;140
37;Salamanca;371;Villasrubias;256;140;116
37;Salamanca;372;Villaverde de Guareña;144;79;65
37;Salamanca;373;Villavieja de Yeltes;748;395;353
37;Salamanca;374;Villoria;1345;693;652
37;Salamanca;375;Villoruela;763;383;380
37;Salamanca;350;Vilvestre;428;208;220
37;Salamanca;376;Vitigudino;2445;1185;1260
37;Salamanca;377;Yecla de Yeltes;230;119;111
37;Salamanca;378;Zamarra;85;50;35
37;Salamanca;379;Zamayón;195;114;81
37;Salamanca;380;Zarapicos;55;32;23
37;Salamanca;381;Zarza de Pumareda, La;142;83;59
37;Salamanca;382;Zorita de la Frontera;160;78;82
38;Santa Cruz de Tenerife;001;Adeje;49030;24675;24355
38;Santa Cruz de Tenerife;002;Agulo;1110;556;554
38;Santa Cruz de Tenerife;003;Alajeró;2026;1068;958
38;Santa Cruz de Tenerife;004;Arafo;5593;2769;2824
38;Santa Cruz de Tenerife;005;Arico;8111;4171;3940
38;Santa Cruz de Tenerife;006;Arona;82777;42033;40744
38;Santa Cruz de Tenerife;007;Barlovento;1926;981;945
38;Santa Cruz de Tenerife;008;Breña Alta;7247;3530;3717
38;Santa Cruz de Tenerife;009;Breña Baja;5821;2941;2880
38;Santa Cruz de Tenerife;010;Buenavista del Norte;4786;2402;2384
38;Santa Cruz de Tenerife;011;Candelaria;28383;13774;14609
38;Santa Cruz de Tenerife;012;Fasnia;2818;1475;1343
38;Santa Cruz de Tenerife;013;Frontera;4184;2095;2089
38;Santa Cruz de Tenerife;014;Fuencaliente de la Palma;1751;874;877
38;Santa Cruz de Tenerife;015;Garachico;4869;2441;2428
38;Santa Cruz de Tenerife;016;Garafía;1730;901;829
38;Santa Cruz de Tenerife;017;Granadilla de Abona;51233;25633;25600
38;Santa Cruz de Tenerife;018;Guancha, La;5540;2697;2843
38;Santa Cruz de Tenerife;019;Guía de Isora;21796;10799;10997
38;Santa Cruz de Tenerife;020;Güímar;20662;10207;10455
38;Santa Cruz de Tenerife;021;Hermigua;1775;912;863
38;Santa Cruz de Tenerife;022;Icod de los Vinos;23316;11456;11860
38;Santa Cruz de Tenerife;024;Llanos de Aridane, Los;20760;10071;10689
38;Santa Cruz de Tenerife;025;Matanza de Acentejo, La;9059;4576;4483
38;Santa Cruz de Tenerife;026;Orotava, La;42187;20649;21538
38;Santa Cruz de Tenerife;027;Paso, El;7623;3807;3816
38;Santa Cruz de Tenerife;901;Pinar de El Hierro, El;1894;993;901
38;Santa Cruz de Tenerife;028;Puerto de la Cruz;30492;14871;15621
38;Santa Cruz de Tenerife;029;Puntagorda;2203;1111;1092
38;Santa Cruz de Tenerife;030;Puntallana;2553;1273;1280
38;Santa Cruz de Tenerife;031;Realejos, Los;36727;17995;18732
38;Santa Cruz de Tenerife;032;Rosario, El;17496;8867;8629
38;Santa Cruz de Tenerife;033;San Andrés y Sauces;4182;2090;2092
38;Santa Cruz de Tenerife;023;San Cristóbal de La Laguna;158911;76703;82208
38;Santa Cruz de Tenerife;034;San Juan de la Rambla;4873;2422;2451
38;Santa Cruz de Tenerife;035;San Miguel de Abona;21621;10934;10687
38;Santa Cruz de Tenerife;036;San Sebastián de la Gomera;9258;4647;4611
38;Santa Cruz de Tenerife;037;Santa Cruz de la Palma;15695;7582;8113
38;Santa Cruz de Tenerife;038;Santa Cruz de Tenerife;209194;99840;109354
38;Santa Cruz de Tenerife;039;Santa Úrsula;14953;7437;7516
38;Santa Cruz de Tenerife;040;Santiago del Teide;11281;5606;5675
38;Santa Cruz de Tenerife;041;Sauzal, El;8940;4445;4495
38;Santa Cruz de Tenerife;042;Silos, Los;4743;2360;2383
38;Santa Cruz de Tenerife;043;Tacoronte;24201;11996;12205
38;Santa Cruz de Tenerife;044;Tanque, El;2852;1380;1472
38;Santa Cruz de Tenerife;045;Tazacorte;4601;2343;2258
38;Santa Cruz de Tenerife;046;Tegueste;11287;5555;5732
38;Santa Cruz de Tenerife;047;Tijarafe;2507;1274;1233
38;Santa Cruz de Tenerife;049;Valle Gran Rey;4630;2357;2273
38;Santa Cruz de Tenerife;050;Vallehermoso;2879;1492;1387
38;Santa Cruz de Tenerife;048;Valverde;5069;2544;2525
38;Santa Cruz de Tenerife;051;Victoria de Acentejo, La;9158;4563;4595
38;Santa Cruz de Tenerife;052;Vilaflor de Chasna;1715;878;837
38;Santa Cruz de Tenerife;053;Villa de Mazo;4859;2440;2419
40;Segovia;001;Abades;857;423;434
40;Segovia;002;Adrada de Pirón;37;20;17
40;Segovia;003;Adrados;127;76;51
40;Segovia;004;Aguilafuente;566;284;282
40;Segovia;005;Alconada de Maderuelo;23;15;8
40;Segovia;012;Aldea Real;279;151;128
40;Segovia;006;Aldealcorvo;20;10;10
40;Segovia;007;Aldealengua de Pedraza;73;46;27
40;Segovia;008;Aldealengua de Santa María;64;32;32
40;Segovia;009;Aldeanueva de la Serrezuela;40;29;11
40;Segovia;010;Aldeanueva del Codonal;113;64;49
40;Segovia;013;Aldeasoña;56;34;22
40;Segovia;014;Aldehorno;53;34;19
40;Segovia;015;Aldehuela del Codonal;23;12;11
40;Segovia;016;Aldeonte;57;31;26
40;Segovia;017;Anaya;125;62;63
40;Segovia;018;Añe;72;42;30
40;Segovia;019;Arahuetes;28;21;7
40;Segovia;020;Arcones;145;71;74
40;Segovia;021;Arevalillo de Cega;19;11;8
40;Segovia;022;Armuña;234;134;100
40;Segovia;024;Ayllón;1182;604;578
40;Segovia;025;Barbolla;158;89;69
40;Segovia;026;Basardilla;143;65;78
40;Segovia;028;Bercial;109;58;51
40;Segovia;029;Bercimuel;22;12;10
40;Segovia;030;Bernardos;465;260;205
40;Segovia;031;Bernuy de Porreros;766;410;356
40;Segovia;032;Boceguillas;719;377;342
40;Segovia;033;Brieva;93;52;41
40;Segovia;034;Caballar;82;46;36
40;Segovia;035;Cabañas de Polendos;171;93;78
40;Segovia;036;Cabezuela;644;334;310
40;Segovia;037;Calabazas de Fuentidueña;26;15;11
40;Segovia;039;Campo de San Pedro;230;126;104
40;Segovia;040;Cantalejo;3562;1773;1789
40;Segovia;041;Cantimpalos;1340;711;629
40;Segovia;161;Carabias;51;36;15
40;Segovia;043;Carbonero el Mayor;2494;1286;1208
40;Segovia;044;Carrascal del Río;146;79;67
40;Segovia;045;Casla;156;80;76
40;Segovia;046;Castillejo de Mesleón;130;70;60
40;Segovia;047;Castro de Fuentidueña;37;23;14
40;Segovia;048;Castrojimeno;33;18;15
40;Segovia;049;Castroserna de Abajo;31;17;14
40;Segovia;051;Castroserracín;40;21;19
40;Segovia;052;Cedillo de la Torre;88;47;41
40;Segovia;053;Cerezo de Abajo;102;55;47
40;Segovia;054;Cerezo de Arriba;128;70;58
40;Segovia;065;Chañe;708;359;349
40;Segovia;055;Cilleruelo de San Mamés;30;19;11
40;Segovia;056;Cobos de Fuentidueña;33;15;18
40;Segovia;057;Coca;1726;869;857
40;Segovia;058;Codorniz;322;164;158
40;Segovia;059;Collado Hermoso;124;65;59
40;Segovia;060;Condado de Castilnovo;85;47;38
40;Segovia;061;Corral de Ayllón;72;43;29
40;Segovia;902;Cozuelos de Fuentidueña;126;69;57
40;Segovia;062;Cubillo;74;46;28
40;Segovia;063;Cuéllar;9659;4892;4767
40;Segovia;905;Cuevas de Provanco;130;75;55
40;Segovia;068;Domingo García;25;15;10
40;Segovia;069;Donhierro;84;46;38
40;Segovia;070;Duruelo;166;98;68
40;Segovia;071;Encinas;41;21;20
40;Segovia;072;Encinillas;312;172;140
40;Segovia;073;Escalona del Prado;495;260;235
40;Segovia;074;Escarabajosa de Cabezas;296;160;136
40;Segovia;075;Escobar de Polendos;165;88;77
40;Segovia;076;Espinar, El;9086;4613;4473
40;Segovia;077;Espirdo;1389;738;651
40;Segovia;078;Fresneda de Cuéllar;163;93;70
40;Segovia;079;Fresno de Cantespino;280;155;125
40;Segovia;080;Fresno de la Fuente;79;45;34
40;Segovia;081;Frumales;114;62;52
40;Segovia;082;Fuente de Santa Cruz;110;60;50
40;Segovia;083;Fuente el Olmo de Fuentidueña;170;77;93
40;Segovia;084;Fuente el Olmo de Íscar;55;30;25
40;Segovia;086;Fuentepelayo;822;438;384
40;Segovia;087;Fuentepiñel;85;51;34
40;Segovia;088;Fuenterrebollo;340;177;163
40;Segovia;089;Fuentesaúco de Fuentidueña;233;121;112
40;Segovia;091;Fuentesoto;106;62;44
40;Segovia;092;Fuentidueña;120;72;48
40;Segovia;093;Gallegos;105;58;47
40;Segovia;094;Garcillán;474;252;222
40;Segovia;095;Gomezserracín;664;355;309
40;Segovia;097;Grajera;228;133;95
40;Segovia;099;Honrubia de la Cuesta;55;33;22
40;Segovia;100;Hontalbilla;303;168;135
40;Segovia;101;Hontanares de Eresma;1456;758;698
40;Segovia;103;Huertos, Los;159;88;71
40;Segovia;104;Ituero y Lama;379;195;184
40;Segovia;105;Juarros de Riomoros;42;25;17
40;Segovia;106;Juarros de Voltoya;197;99;98
40;Segovia;107;Labajos;101;59;42
40;Segovia;108;Laguna de Contreras;110;65;45
40;Segovia;109;Languilla;73;43;30
40;Segovia;110;Lastras de Cuéllar;344;185;159
40;Segovia;111;Lastras del Pozo;62;33;29
40;Segovia;112;Lastrilla, La;4020;2042;1978
40;Segovia;113;Losa, La;519;294;225
40;Segovia;115;Maderuelo;137;78;59
40;Segovia;903;Marazoleja;98;65;33
40;Segovia;118;Marazuela;48;30;18
40;Segovia;119;Martín Miguel;211;127;84
40;Segovia;120;Martín Muñoz de la Dehesa;227;117;110
40;Segovia;121;Martín Muñoz de las Posadas;284;155;129
40;Segovia;122;Marugán;606;334;272
40;Segovia;124;Mata de Cuéllar;253;133;120
40;Segovia;123;Matabuena;135;76;59
40;Segovia;125;Matilla, La;78;49;29
40;Segovia;126;Melque de Cercos;67;35;32
40;Segovia;127;Membibre de la Hoz;35;18;17
40;Segovia;128;Migueláñez;131;70;61
40;Segovia;129;Montejo de Arévalo;171;91;80
40;Segovia;130;Montejo de la Vega de la Serrezuela;138;81;57
40;Segovia;131;Monterrubio;58;31;27
40;Segovia;132;Moral de Hornuez;49;28;21
40;Segovia;134;Mozoncillo;879;483;396
40;Segovia;135;Muñopedro;313;171;142
40;Segovia;136;Muñoveros;143;70;73
40;Segovia;138;Nava de la Asunción;2747;1404;1343
40;Segovia;139;Navafría;285;159;126
40;Segovia;140;Navalilla;100;52;48
40;Segovia;141;Navalmanzano;1047;545;502
40;Segovia;142;Navares de Ayuso;53;27;26
40;Segovia;143;Navares de Enmedio;92;56;36
40;Segovia;144;Navares de las Cuevas;21;14;7
40;Segovia;145;Navas de Oro;1305;660;645
40;Segovia;904;Navas de Riofrío;386;183;203
40;Segovia;146;Navas de San Antonio;343;183;160
40;Segovia;148;Nieva;263;127;136
40;Segovia;149;Olombrada;536;292;244
40;Segovia;150;Orejana;56;34;22
40;Segovia;151;Ortigosa de Pestaño;49;26;23
40;Segovia;901;Ortigosa del Monte;544;280;264
40;Segovia;152;Otero de Herreros;943;479;464
40;Segovia;154;Pajarejos;21;11;10
40;Segovia;155;Palazuelos de Eresma;5538;2884;2654
40;Segovia;156;Pedraza;340;194;146
40;Segovia;157;Pelayos del Arroyo;42;25;17
40;Segovia;158;Perosillo;15;12;3
40;Segovia;159;Pinarejos;184;106;78
40;Segovia;160;Pinarnegrillo;92;51;41
40;Segovia;162;Prádena;510;270;240
40;Segovia;163;Puebla de Pedraza;43;23;20
40;Segovia;164;Rapariegos;208;105;103
40;Segovia;181;Real Sitio de San Ildefonso;5285;2583;2702
40;Segovia;165;Rebollo;79;41;38
40;Segovia;166;Remondo;304;156;148
40;Segovia;168;Riaguas de San Bartolomé;24;16;8
40;Segovia;170;Riaza;2117;1122;995
40;Segovia;171;Ribota;47;34;13
40;Segovia;172;Riofrío de Riaza;44;26;18
40;Segovia;173;Roda de Eresma;197;106;91
40;Segovia;174;Sacramenia;385;188;197
40;Segovia;176;Samboal;460;247;213
40;Segovia;177;San Cristóbal de Cuéllar;143;78;65
40;Segovia;178;San Cristóbal de la Vega;93;49;44
40;Segovia;906;San Cristóbal de Segovia;3080;1533;1547
40;Segovia;182;San Martín y Mudrián;248;119;129
40;Segovia;183;San Miguel de Bernuy;148;75;73
40;Segovia;184;San Pedro de Gaíllos;271;147;124
40;Segovia;179;Sanchonuño;973;477;496
40;Segovia;180;Sangarcía;315;177;138
40;Segovia;185;Santa María la Real de Nieva;961;525;436
40;Segovia;186;Santa Marta del Cerro;33;18;15
40;Segovia;188;Santiuste de Pedraza;91;59;32
40;Segovia;189;Santiuste de San Juan Bautista;536;296;240
40;Segovia;190;Santo Domingo de Pirón;53;29;24
40;Segovia;191;Santo Tomé del Puerto;260;142;118
40;Segovia;192;Sauquillo de Cabezas;146;78;68
40;Segovia;193;Sebúlcor;274;141;133
40;Segovia;194;Segovia;52057;24328;27729
40;Segovia;195;Sepúlveda;967;502;465
40;Segovia;196;Sequera de Fresno;34;22;12
40;Segovia;198;Sotillo;28;16;12
40;Segovia;199;Sotosalbos;118;62;56
40;Segovia;200;Tabanera la Luenga;49;25;24
40;Segovia;201;Tolocirio;46;23;23
40;Segovia;206;Torre Val de San Pedro;192;100;92
40;Segovia;202;Torreadrada;55;28;27
40;Segovia;203;Torrecaballeros;1372;706;666
40;Segovia;204;Torrecilla del Pinar;175;95;80
40;Segovia;205;Torreiglesias;252;128;124
40;Segovia;207;Trescasas;1074;549;525
40;Segovia;208;Turégano;986;501;485
40;Segovia;210;Urueñas;102;65;37
40;Segovia;211;Valdeprados;69;37;32
40;Segovia;212;Valdevacas de Montejo;29;14;15
40;Segovia;213;Valdevacas y Guijar;95;53;42
40;Segovia;218;Valle de Tabladillo;82;49;33
40;Segovia;219;Vallelado;712;373;339
40;Segovia;220;Valleruela de Pedraza;68;32;36
40;Segovia;221;Valleruela de Sepúlveda;52;27;25
40;Segovia;214;Valseca;234;129;105
40;Segovia;215;Valtiendas;82;50;32
40;Segovia;216;Valverde del Majano;1115;573;542
40;Segovia;222;Veganzones;219;118;101
40;Segovia;223;Vegas de Matute;293;171;122
40;Segovia;224;Ventosilla y Tejadilla;16;10;6
40;Segovia;225;Villacastín;1483;785;698
40;Segovia;228;Villaverde de Íscar;591;310;281
40;Segovia;229;Villaverde de Montejo;26;17;9
40;Segovia;230;Villeguillo;105;58;47
40;Segovia;231;Yanguas de Eresma;125;68;57
40;Segovia;233;Zarzuela del Monte;485;253;232
40;Segovia;234;Zarzuela del Pinar;424;219;205
41;Sevilla;001;Aguadulce;2035;1005;1030
41;Sevilla;002;Alanís;1706;852;854
41;Sevilla;003;Albaida del Aljarafe;3201;1591;1610
41;Sevilla;004;Alcalá de Guadaíra;75533;37524;38009
41;Sevilla;005;Alcalá del Río;12186;6174;6012
41;Sevilla;006;Alcolea del Río;3347;1670;1677
41;Sevilla;007;Algaba, La;16503;8186;8317
41;Sevilla;008;Algámitas;1253;651;602
41;Sevilla;009;Almadén de la Plata;1307;673;634
41;Sevilla;010;Almensilla;6175;3095;3080
41;Sevilla;011;Arahal;19533;9675;9858
41;Sevilla;012;Aznalcázar;4588;2335;2253
41;Sevilla;013;Aznalcóllar;6083;3093;2990
41;Sevilla;014;Badolatosa;3079;1586;1493
41;Sevilla;015;Benacazón;7222;3642;3580
41;Sevilla;016;Bollullos de la Mitación;10931;5459;5472
41;Sevilla;017;Bormujos;22180;10982;11198
41;Sevilla;018;Brenes;12501;6185;6316
41;Sevilla;019;Burguillos;6766;3414;3352
41;Sevilla;020;Cabezas de San Juan, Las;16358;8170;8188
41;Sevilla;021;Camas;27560;13486;14074
41;Sevilla;022;Campana, La;5238;2624;2614
41;Sevilla;023;Cantillana;10736;5443;5293
41;Sevilla;901;Cañada Rosal;3325;1636;1689
41;Sevilla;024;Carmona;28834;14501;14333
41;Sevilla;025;Carrión de los Céspedes;2547;1242;1305
41;Sevilla;026;Casariche;5429;2799;2630
41;Sevilla;027;Castilblanco de los Arroyos;4899;2465;2434
41;Sevilla;028;Castilleja de Guzmán;2833;1453;1380
41;Sevilla;029;Castilleja de la Cuesta;17516;8463;9053
41;Sevilla;030;Castilleja del Campo;640;330;310
41;Sevilla;031;Castillo de las Guardas, El;1468;771;697
41;Sevilla;032;Cazalla de la Sierra;4684;2310;2374
41;Sevilla;033;Constantina;5864;2901;2963
41;Sevilla;034;Coria del Río;30908;15418;15490
41;Sevilla;035;Coripe;1238;610;628
41;Sevilla;036;Coronil, El;4717;2363;2354
41;Sevilla;037;Corrales, Los;3938;2013;1925
41;Sevilla;903;Cuervo de Sevilla, El;8656;4347;4309
41;Sevilla;038;Dos Hermanas;135050;66330;68720
41;Sevilla;039;Écija;39893;19685;20208
41;Sevilla;040;Espartinas;15824;7921;7903
41;Sevilla;041;Estepa;12497;6213;6284
41;Sevilla;042;Fuentes de Andalucía;7152;3562;3590
41;Sevilla;043;Garrobo, El;782;397;385
41;Sevilla;044;Gelves;10193;5063;5130
41;Sevilla;045;Gerena;7674;3839;3835
41;Sevilla;046;Gilena;3727;1873;1854
41;Sevilla;047;Gines;13428;6618;6810
41;Sevilla;048;Guadalcanal;2608;1316;1292
41;Sevilla;049;Guillena;12903;6483;6420
41;Sevilla;050;Herrera;6464;3210;3254
41;Sevilla;051;Huévar del Aljarafe;3060;1568;1492
41;Sevilla;902;Isla Mayor;5825;2897;2928
41;Sevilla;052;Lantejuela;3846;1964;1882
41;Sevilla;053;Lebrija;27578;13732;13846
41;Sevilla;054;Lora de Estepa;873;440;433
41;Sevilla;055;Lora del Río;18630;9212;9418
41;Sevilla;056;Luisiana, La;4578;2313;2265
41;Sevilla;057;Madroño, El;287;147;140
41;Sevilla;058;Mairena del Alcor;23698;11862;11836
41;Sevilla;059;Mairena del Aljarafe;46555;22632;23923
41;Sevilla;060;Marchena;19329;9619;9710
41;Sevilla;061;Marinaleda;2592;1320;1272
41;Sevilla;062;Martín de la Jara;2665;1369;1296
41;Sevilla;063;Molares, Los;3518;1794;1724
41;Sevilla;064;Montellano;7053;3529;3524
41;Sevilla;065;Morón de la Frontera;27633;13606;14027
41;Sevilla;066;Navas de la Concepción, Las;1542;767;775
41;Sevilla;067;Olivares;9466;4722;4744
41;Sevilla;068;Osuna;17621;8751;8870
41;Sevilla;069;Palacios y Villafranca, Los;38548;19323;19225
41;Sevilla;904;Palmar de Troya, El;2343;1169;1174
41;Sevilla;070;Palomares del Río;8843;4431;4412
41;Sevilla;071;Paradas;6857;3410;3447
41;Sevilla;072;Pedrera;5158;2561;2597
41;Sevilla;073;Pedroso, El;2009;994;1015
41;Sevilla;074;Peñaflor;3639;1829;1810
41;Sevilla;075;Pilas;13952;6992;6960
41;Sevilla;076;Pruna;2605;1325;1280
41;Sevilla;077;Puebla de Cazalla, La;10932;5456;5476
41;Sevilla;078;Puebla de los Infantes, La;2980;1475;1505
41;Sevilla;079;Puebla del Río, La;11920;5880;6040
41;Sevilla;080;Real de la Jara, El;1494;738;756
41;Sevilla;081;Rinconada, La;39062;19299;19763
41;Sevilla;082;Roda de Andalucía, La;4175;2065;2110
41;Sevilla;083;Ronquillo, El;1377;687;690
41;Sevilla;084;Rubio, El;3369;1681;1688
41;Sevilla;085;Salteras;5564;2695;2869
41;Sevilla;086;San Juan de Aznalfarache;21774;10480;11294
41;Sevilla;088;San Nicolás del Puerto;596;311;285
41;Sevilla;087;Sanlúcar la Mayor;13943;6887;7056
41;Sevilla;089;Santiponce;8538;4244;4294
41;Sevilla;090;Saucejo, El;4235;2099;2136
41;Sevilla;091;Sevilla;691395;328013;363382
41;Sevilla;092;Tocina;9486;4709;4777
41;Sevilla;093;Tomares;25455;12579;12876
41;Sevilla;094;Umbrete;9000;4503;4497
41;Sevilla;095;Utrera;50962;25173;25789
41;Sevilla;096;Valencina de la Concepción;7776;3801;3975
41;Sevilla;097;Villamanrique de la Condesa;4477;2201;2276
41;Sevilla;100;Villanueva de San Juan;1090;535;555
41;Sevilla;098;Villanueva del Ariscal;6591;3201;3390
41;Sevilla;099;Villanueva del Río y Minas;4847;2448;2399
41;Sevilla;101;Villaverde del Río;7842;3959;3883
41;Sevilla;102;Viso del Alcor, El;19324;9651;9673
42;Soria;001;Abejar;286;151;135
42;Soria;003;Adradas;59;32;27
42;Soria;004;Ágreda;3026;1553;1473
42;Soria;006;Alconaba;179;116;63
42;Soria;007;Alcubilla de Avellaneda;105;58;47
42;Soria;008;Alcubilla de las Peñas;52;31;21
42;Soria;009;Aldealafuente;88;51;37
42;Soria;010;Aldealices;35;22;13
42;Soria;011;Aldealpozo;15;7;8
42;Soria;012;Aldealseñor;29;16;13
42;Soria;013;Aldehuela de Periáñez;32;19;13
42;Soria;014;Aldehuelas, Las;60;33;27
42;Soria;015;Alentisque;30;19;11
42;Soria;016;Aliud;20;15;5
42;Soria;017;Almajano;191;99;92
42;Soria;018;Almaluez;130;75;55
42;Soria;019;Almarza;602;345;257
42;Soria;020;Almazán;5477;2785;2692
42;Soria;021;Almazul;62;40;22
42;Soria;022;Almenar de Soria;232;136;96
42;Soria;023;Alpanseque;56;34;22
42;Soria;024;Arancón;84;56;28
42;Soria;025;Arcos de Jalón;1454;750;704
42;Soria;026;Arenillas;47;26;21
42;Soria;027;Arévalo de la Sierra;76;48;28
42;Soria;028;Ausejo de la Sierra;87;48;39
42;Soria;029;Baraona;133;74;59
42;Soria;030;Barca;103;65;38
42;Soria;031;Barcones;20;13;7
42;Soria;032;Bayubas de Abajo;141;77;64
42;Soria;033;Bayubas de Arriba;53;32;21
42;Soria;034;Beratón;38;19;19
42;Soria;035;Berlanga de Duero;842;438;404
42;Soria;036;Blacos;44;22;22
42;Soria;037;Bliecos;31;19;12
42;Soria;038;Borjabad;33;20;13
42;Soria;039;Borobia;246;136;110
42;Soria;041;Buberos;31;16;15
42;Soria;042;Buitrago;69;38;31
42;Soria;043;Burgo de Osma-Ciudad de Osma;5038;2526;2512
42;Soria;044;Cabrejas del Campo;51;32;19
42;Soria;045;Cabrejas del Pinar;352;202;150
42;Soria;046;Calatañazor;51;29;22
42;Soria;048;Caltojar;56;39;17
42;Soria;049;Candilichera;108;64;44
42;Soria;050;Cañamaque;34;23;11
42;Soria;051;Carabantes;14;7;7
42;Soria;052;Caracena;14;10;4
42;Soria;053;Carrascosa de Abajo;20;13;7
42;Soria;054;Carrascosa de la Sierra;17;12;5
42;Soria;055;Casarejos;161;84;77
42;Soria;056;Castilfrío de la Sierra;37;24;13
42;Soria;058;Castillejo de Robledo;101;59;42
42;Soria;057;Castilruiz;161;84;77
42;Soria;059;Centenera de Andaluz;19;10;9
42;Soria;060;Cerbón;27;18;9
42;Soria;061;Cidones;300;182;118
42;Soria;062;Cigudosa;21;14;7
42;Soria;063;Cihuela;48;27;21
42;Soria;064;Ciria;79;41;38
42;Soria;065;Cirujales del Río;22;16;6
42;Soria;068;Coscurita;77;49;28
42;Soria;069;Covaleda;1644;848;796
42;Soria;070;Cubilla;31;18;13
42;Soria;071;Cubo de la Solana;181;104;77
42;Soria;073;Cueva de Ágreda;71;44;27
42;Soria;075;Dévanos;78;42;36
42;Soria;076;Deza;217;113;104
42;Soria;078;Duruelo de la Sierra;1088;560;528
42;Soria;079;Escobosa de Almazán;20;13;7
42;Soria;080;Espeja de San Marcelino;150;89;61
42;Soria;081;Espejón;147;78;69
42;Soria;082;Estepa de San Juan;9;6;3
42;Soria;083;Frechilla de Almazán;23;12;11
42;Soria;084;Fresno de Caracena;20;14;6
42;Soria;085;Fuentearmegil;171;98;73
42;Soria;086;Fuentecambrón;32;19;13
42;Soria;087;Fuentecantos;63;32;31
42;Soria;088;Fuentelmonge;66;37;29
42;Soria;089;Fuentelsaz de Soria;61;32;29
42;Soria;090;Fuentepinilla;82;52;30
42;Soria;092;Fuentes de Magaña;59;36;23
42;Soria;093;Fuentestrún;44;30;14
42;Soria;094;Garray;721;385;336
42;Soria;095;Golmayo;2778;1438;1340
42;Soria;096;Gómara;294;159;135
42;Soria;097;Gormaz;20;15;5
42;Soria;098;Herrera de Soria;9;7;2
42;Soria;100;Hinojosa del Campo;29;20;9
42;Soria;103;Langa de Duero;683;365;318
42;Soria;105;Liceras;47;23;24
42;Soria;106;Losilla, La;13;9;4
42;Soria;107;Magaña;68;38;30
42;Soria;108;Maján;9;6;3
42;Soria;110;Matalebreras;67;44;23
42;Soria;111;Matamala de Almazán;283;157;126
42;Soria;113;Medinaceli;682;347;335
42;Soria;115;Miño de Medinaceli;87;53;34
42;Soria;116;Miño de San Esteban;38;27;11
42;Soria;117;Molinos de Duero;158;82;76
42;Soria;118;Momblona;18;14;4
42;Soria;119;Monteagudo de las Vicarías;176;89;87
42;Soria;120;Montejo de Tiermes;151;95;56
42;Soria;121;Montenegro de Cameros;54;36;18
42;Soria;123;Morón de Almazán;194;102;92
42;Soria;124;Muriel de la Fuente;58;35;23
42;Soria;125;Muriel Viejo;79;50;29
42;Soria;127;Nafría de Ucero;33;19;14
42;Soria;128;Narros;46;26;20
42;Soria;129;Navaleno;768;405;363
42;Soria;130;Nepas;52;36;16
42;Soria;131;Nolay;55;30;25
42;Soria;132;Noviercas;154;90;64
42;Soria;134;Ólvega;3675;1890;1785
42;Soria;135;Oncala;71;42;29
42;Soria;139;Pinilla del Campo;21;12;9
42;Soria;140;Portillo de Soria;15;10;5
42;Soria;141;Póveda de Soria, La;104;62;42
42;Soria;142;Pozalmuro;50;26;24
42;Soria;144;Quintana Redonda;492;277;215
42;Soria;145;Quintanas de Gormaz;142;86;56
42;Soria;148;Quiñonería;9;5;4
42;Soria;149;Rábanos, Los;445;252;193
42;Soria;151;Rebollar;42;20;22
42;Soria;152;Recuerda;71;42;29
42;Soria;153;Rello;15;9;6
42;Soria;154;Renieblas;103;65;38
42;Soria;155;Retortillo de Soria;156;90;66
42;Soria;156;Reznos;33;22;11
42;Soria;157;Riba de Escalote, La;11;7;4
42;Soria;158;Rioseco de Soria;124;74;50
42;Soria;159;Rollamienta;40;27;13
42;Soria;160;Royo, El;272;146;126
42;Soria;161;Salduero;152;80;72
42;Soria;162;San Esteban de Gormaz;2956;1562;1394
42;Soria;163;San Felices;53;33;20
42;Soria;164;San Leonardo de Yagüe;2054;1048;1006
42;Soria;165;San Pedro Manrique;623;347;276
42;Soria;166;Santa Cruz de Yanguas;65;38;27
42;Soria;167;Santa María de Huerta;260;145;115
42;Soria;168;Santa María de las Hoyas;94;56;38
42;Soria;171;Serón de Nágima;128;72;56
42;Soria;172;Soliedra;31;17;14
42;Soria;173;Soria;39821;18788;21033
42;Soria;174;Sotillo del Rincón;176;92;84
42;Soria;175;Suellacabras;24;14;10
42;Soria;176;Tajahuerce;26;14;12
42;Soria;177;Tajueco;58;34;24
42;Soria;178;Talveila;96;57;39
42;Soria;181;Tardelcuende;414;215;199
42;Soria;182;Taroda;47;27;20
42;Soria;183;Tejado;101;57;44
42;Soria;184;Torlengua;56;33;23
42;Soria;185;Torreblacos;24;12;12
42;Soria;187;Torrubia de Soria;64;45;19
42;Soria;188;Trévago;45;20;25
42;Soria;189;Ucero;50;26;24
42;Soria;190;Vadillo;89;46;43
42;Soria;191;Valdeavellano de Tera;202;111;91
42;Soria;192;Valdegeña;34;26;8
42;Soria;193;Valdelagua del Cerro;14;9;5
42;Soria;194;Valdemaluque;147;67;80
42;Soria;195;Valdenebro;94;53;41
42;Soria;196;Valdeprado;7;4;3
42;Soria;197;Valderrodilla;68;36;32
42;Soria;198;Valtajeros;18;12;6
42;Soria;200;Velamazán;73;47;26
42;Soria;201;Velilla de la Sierra;24;14;10
42;Soria;202;Velilla de los Ajos;19;11;8
42;Soria;204;Viana de Duero;54;38;16
42;Soria;205;Villaciervos;79;47;32
42;Soria;206;Villanueva de Gormaz;8;6;2
42;Soria;207;Villar del Ala;49;26;23
42;Soria;208;Villar del Campo;22;14;8
42;Soria;209;Villar del Río;144;86;58
42;Soria;211;Villares de Soria, Los;88;48;40
42;Soria;212;Villasayas;66;43;23
42;Soria;213;Villaseca de Arciel;27;17;10
42;Soria;215;Vinuesa;847;453;394
42;Soria;216;Vizmanos;29;18;11
42;Soria;217;Vozmediano;38;24;14
42;Soria;218;Yanguas;103;70;33
42;Soria;219;Yelo;45;27;18
43;Tarragona;001;Aiguamúrcia;930;483;447
43;Tarragona;002;Albinyana;2468;1273;1195
43;Tarragona;003;Albiol, L';500;272;228
43;Tarragona;004;Alcanar;9434;4782;4652
43;Tarragona;005;Alcover;5144;2555;2589
43;Tarragona;904;Aldea, L';4147;2197;1950
43;Tarragona;006;Aldover;905;457;448
43;Tarragona;007;Aleixar, L';893;458;435
43;Tarragona;008;Alfara de Carles;376;201;175
43;Tarragona;009;Alforja;1783;919;864
43;Tarragona;010;Alió;458;219;239
43;Tarragona;011;Almoster;1341;674;667
43;Tarragona;012;Altafulla;5307;2579;2728
43;Tarragona;013;Ametlla de Mar, L';6866;3492;3374
43;Tarragona;906;Ampolla, L';3277;1683;1594
43;Tarragona;014;Amposta;21115;10675;10440
43;Tarragona;016;Arboç, L';5609;2881;2728
43;Tarragona;015;Arbolí;127;74;53
43;Tarragona;017;Argentera, L';117;66;51
43;Tarragona;018;Arnes;444;219;225
43;Tarragona;019;Ascó;1644;844;800
43;Tarragona;020;Banyeres del Penedès;3207;1625;1582
43;Tarragona;021;Barberà de la Conca;471;260;211
43;Tarragona;022;Batea;1901;949;952
43;Tarragona;023;Bellmunt del Priorat;273;142;131
43;Tarragona;024;Bellvei;2237;1162;1075
43;Tarragona;025;Benifallet;723;336;387
43;Tarragona;026;Benissanet;1140;630;510
43;Tarragona;027;Bisbal de Falset, La;211;116;95
43;Tarragona;028;Bisbal del Penedès, La;3631;1918;1713
43;Tarragona;029;Blancafort;382;200;182
43;Tarragona;030;Bonastre;685;359;326
43;Tarragona;031;Borges del Camp, Les;2056;1053;1003
43;Tarragona;032;Bot;554;284;270
43;Tarragona;033;Botarell;1077;552;525
43;Tarragona;034;Bràfim;695;355;340
43;Tarragona;035;Cabacés;302;162;140
43;Tarragona;036;Cabra del Camp;1175;613;562
43;Tarragona;037;Calafell;27601;13887;13714
43;Tarragona;903;Camarles;3194;1617;1577
43;Tarragona;038;Cambrils;34734;16990;17744
43;Tarragona;907;Canonja, La;5956;2912;3044
43;Tarragona;039;Capafonts;111;58;53
43;Tarragona;040;Capçanes;392;197;195
43;Tarragona;041;Caseres;237;117;120
43;Tarragona;042;Castellvell del Camp;2828;1417;1411
43;Tarragona;043;Catllar, El;4557;2366;2191
43;Tarragona;045;Colldejou;168;93;75
43;Tarragona;046;Conesa;100;50;50
43;Tarragona;047;Constantí;6665;3445;3220
43;Tarragona;048;Corbera d'Ebre;1003;529;474
43;Tarragona;049;Cornudella de Montsant;944;501;443
43;Tarragona;050;Creixell;3758;1895;1863
43;Tarragona;051;Cunit;13533;6650;6883
43;Tarragona;901;Deltebre;11578;5849;5729
43;Tarragona;053;Duesaigües;244;138;106
43;Tarragona;054;Espluga de Francolí, L';3736;1830;1906
43;Tarragona;055;Falset;2735;1359;1376
43;Tarragona;056;Fatarella, La;926;451;475
43;Tarragona;057;Febró, La;40;25;15
43;Tarragona;058;Figuera, La;114;62;52
43;Tarragona;059;Figuerola del Camp;329;164;165
43;Tarragona;060;Flix;3410;1723;1687
43;Tarragona;061;Forès;43;26;17
43;Tarragona;062;Freginals;385;206;179
43;Tarragona;063;Galera, La;736;382;354
43;Tarragona;064;Gandesa;3096;1589;1507
43;Tarragona;065;Garcia;527;259;268
43;Tarragona;066;Garidells, Els;190;96;94
43;Tarragona;067;Ginestar;764;407;357
43;Tarragona;068;Godall;598;296;302
43;Tarragona;069;Gratallops;237;128;109
43;Tarragona;070;Guiamets, Els;278;133;145
43;Tarragona;071;Horta de Sant Joan;1146;599;547
43;Tarragona;072;Lloar, El;105;56;49
43;Tarragona;073;Llorac;91;48;43
43;Tarragona;074;Llorenç del Penedès;2395;1180;1215
43;Tarragona;076;Marçà;600;312;288
43;Tarragona;075;Margalef;106;63;43
43;Tarragona;077;Mas de Barberans;564;281;283
43;Tarragona;078;Masdenverge;1071;546;525
43;Tarragona;079;Masllorenç;505;274;231
43;Tarragona;080;Masó, La;280;148;132
43;Tarragona;081;Maspujols;823;421;402
43;Tarragona;082;Masroig, El;492;273;219
43;Tarragona;083;Milà, El;190;91;99
43;Tarragona;084;Miravet;706;375;331
43;Tarragona;085;Molar, El;291;155;136
43;Tarragona;086;Montblanc;7379;3742;3637
43;Tarragona;088;Montbrió del Camp;2909;1499;1410
43;Tarragona;089;Montferri;403;210;193
43;Tarragona;090;Montmell, El;1582;842;740
43;Tarragona;091;Mont-ral;168;99;69
43;Tarragona;092;Mont-roig del Camp;12460;6423;6037
43;Tarragona;093;Móra d'Ebre;5695;2874;2821
43;Tarragona;094;Móra la Nova;3108;1567;1541
43;Tarragona;095;Morell, El;3742;1917;1825
43;Tarragona;096;Morera de Montsant, La;159;87;72
43;Tarragona;097;Nou de Gaià, La;600;294;306
43;Tarragona;098;Nulles;509;274;235
43;Tarragona;100;Pallaresos, Els;4850;2423;2427
43;Tarragona;099;Palma d'Ebre, La;338;165;173
43;Tarragona;101;Passanant i Belltall;155;94;61
43;Tarragona;102;Paüls;545;273;272
43;Tarragona;103;Perafort;1264;659;605
43;Tarragona;104;Perelló, El;2826;1442;1384
43;Tarragona;105;Piles, Les;210;114;96
43;Tarragona;106;Pinell de Brai, El;1008;513;495
43;Tarragona;107;Pira;503;270;233
43;Tarragona;108;Pla de Santa Maria, El;2348;1229;1119
43;Tarragona;109;Pobla de Mafumet, La;3971;2017;1954
43;Tarragona;110;Pobla de Massaluca, La;317;180;137
43;Tarragona;111;Pobla de Montornès, La;2884;1503;1381
43;Tarragona;112;Poboleda;321;166;155
43;Tarragona;113;Pont d'Armentera, El;488;249;239
43;Tarragona;141;Pontils;122;66;56
43;Tarragona;114;Porrera;424;223;201
43;Tarragona;115;Pradell de la Teixeta;158;74;84
43;Tarragona;116;Prades;588;311;277
43;Tarragona;117;Prat de Comte;177;97;80
43;Tarragona;118;Pratdip;726;388;338
43;Tarragona;119;Puigpelat;1163;604;559
43;Tarragona;120;Querol;518;285;233
43;Tarragona;121;Rasquera;783;388;395
43;Tarragona;122;Renau;162;85;77
43;Tarragona;123;Reus;106168;51335;54833
43;Tarragona;124;Riba, La;585;319;266
43;Tarragona;125;Riba-roja d'Ebre;1110;583;527
43;Tarragona;126;Riera de Gaià, La;1742;874;868
43;Tarragona;127;Riudecanyes;1146;611;535
43;Tarragona;128;Riudecols;1189;617;572
43;Tarragona;129;Riudoms;6569;3352;3217
43;Tarragona;130;Rocafort de Queralt;211;114;97
43;Tarragona;131;Roda de Berà;6785;3463;3322
43;Tarragona;132;Rodonyà;494;265;229
43;Tarragona;133;Roquetes;8079;4170;3909
43;Tarragona;134;Rourell, El;372;193;179
43;Tarragona;135;Salomó;549;286;263
43;Tarragona;905;Salou;28526;14736;13790
43;Tarragona;136;Sant Carles de la Ràpita;14953;7316;7637
43;Tarragona;137;Sant Jaume dels Domenys;2624;1348;1276
43;Tarragona;902;Sant Jaume d'Enveja;3527;1781;1746
43;Tarragona;138;Santa Bàrbara;3715;1886;1829
43;Tarragona;139;Santa Coloma de Queralt;2672;1341;1331
43;Tarragona;140;Santa Oliva;3353;1714;1639
43;Tarragona;142;Sarral;1538;798;740
43;Tarragona;143;Savallà del Comtat;53;26;27
43;Tarragona;144;Secuita, La;1708;859;849
43;Tarragona;145;Selva del Camp, La;5683;2867;2816
43;Tarragona;146;Senan;44;30;14
43;Tarragona;044;Sénia, La;5640;2839;2801
43;Tarragona;147;Solivella;632;333;299
43;Tarragona;148;Tarragona;136496;66666;69830
43;Tarragona;149;Tivenys;902;457;445
43;Tarragona;150;Tivissa;1619;812;807
43;Tarragona;151;Torre de Fontaubella, La;131;69;62
43;Tarragona;152;Torre de l'Espanyol, La;601;308;293
43;Tarragona;153;Torredembarra;16567;8134;8433
43;Tarragona;154;Torroja del Priorat;152;85;67
43;Tarragona;155;Tortosa;33439;16594;16845
43;Tarragona;156;Ulldecona;6525;3494;3031
43;Tarragona;157;Ulldemolins;398;226;172
43;Tarragona;158;Vallclara;88;52;36
43;Tarragona;159;Vallfogona de Riucorb;77;47;30
43;Tarragona;160;Vallmoll;1774;890;884
43;Tarragona;161;Valls;24477;12286;12191
43;Tarragona;162;Vandellòs i l'Hospitalet de l'Infant;6603;3304;3299
43;Tarragona;163;Vendrell, El;38373;19052;19321
43;Tarragona;164;Vespella de Gaià;417;230;187
43;Tarragona;165;Vilabella;729;373;356
43;Tarragona;175;Vilalba dels Arcs;621;313;308
43;Tarragona;166;Vilallonga del Camp;2405;1223;1182
43;Tarragona;168;Vilanova de Prades;107;56;51
43;Tarragona;167;Vilanova d'Escornalbou;565;296;269
43;Tarragona;169;Vilaplana;555;297;258
43;Tarragona;170;Vila-rodona;1276;677;599
43;Tarragona;171;Vila-seca;22555;11317;11238
43;Tarragona;172;Vilaverd;443;237;206
43;Tarragona;173;Vilella Alta, La;133;72;61
43;Tarragona;174;Vilella Baixa, La;204;110;94
43;Tarragona;176;Vimbodí i Poblet;890;478;412
43;Tarragona;177;Vinebre;425;215;210
43;Tarragona;178;Vinyols i els Arcs;2124;1113;1011
43;Tarragona;052;Xerta;1154;569;585
44;Teruel;001;Ababuj;77;46;31
44;Teruel;002;Abejuela;50;31;19
44;Teruel;003;Aguatón;19;7;12
44;Teruel;004;Aguaviva;516;250;266
44;Teruel;005;Aguilar del Alfambra;69;40;29
44;Teruel;006;Alacón;238;124;114
44;Teruel;007;Alba;165;93;72
44;Teruel;008;Albalate del Arzobispo;1972;1007;965
44;Teruel;009;Albarracín;1006;514;492
44;Teruel;010;Albentosa;289;156;133
44;Teruel;011;Alcaine;53;34;19
44;Teruel;012;Alcalá de la Selva;331;179;152
44;Teruel;013;Alcañiz;16006;7953;8053
44;Teruel;014;Alcorisa;3298;1678;1620
44;Teruel;016;Alfambra;482;251;231
44;Teruel;017;Aliaga;326;180;146
44;Teruel;021;Allepuz;124;63;61
44;Teruel;022;Alloza;572;300;272
44;Teruel;023;Allueva;24;16;8
44;Teruel;018;Almohaja;14;10;4
44;Teruel;019;Alobras;64;40;24
44;Teruel;020;Alpeñés;21;13;8
44;Teruel;024;Anadón;32;20;12
44;Teruel;025;Andorra;7345;3686;3659
44;Teruel;026;Arcos de las Salinas;118;70;48
44;Teruel;027;Arens de Lledó;205;105;100
44;Teruel;028;Argente;193;96;97
44;Teruel;029;Ariño;714;363;351
44;Teruel;031;Azaila;93;48;45
44;Teruel;032;Bádenas;19;12;7
44;Teruel;033;Báguena;285;155;130
44;Teruel;034;Bañón;146;82;64
44;Teruel;035;Barrachina;109;58;51
44;Teruel;036;Bea;29;18;11
44;Teruel;037;Beceite;531;273;258
44;Teruel;039;Bello;219;110;109
44;Teruel;038;Belmonte de San José;123;58;65
44;Teruel;040;Berge;241;118;123
44;Teruel;041;Bezas;67;43;24
44;Teruel;042;Blancas;125;74;51
44;Teruel;043;Blesa;92;59;33
44;Teruel;044;Bordón;105;58;47
44;Teruel;045;Bronchales;417;236;181
44;Teruel;046;Bueña;49;26;23
44;Teruel;047;Burbáguena;211;113;98
44;Teruel;048;Cabra de Mora;51;33;18
44;Teruel;049;Calaceite;978;483;495
44;Teruel;050;Calamocha;4429;2192;2237
44;Teruel;051;Calanda;3822;1905;1917
44;Teruel;052;Calomarde;74;44;30
44;Teruel;053;Camañas;133;77;56
44;Teruel;054;Camarena de la Sierra;107;67;40
44;Teruel;055;Camarillas;92;57;35
44;Teruel;056;Caminreal;615;320;295
44;Teruel;059;Cantavieja;729;386;343
44;Teruel;060;Cañada de Benatanduz;33;21;12
44;Teruel;061;Cañada de Verich, La;92;55;37
44;Teruel;062;Cañada Vellida;36;24;12
44;Teruel;063;Cañizar del Olivar;100;57;43
44;Teruel;064;Cascante del Río;67;41;26
44;Teruel;065;Castejón de Tornos;55;36;19
44;Teruel;066;Castel de Cabra;93;52;41
44;Teruel;070;Castellar, El;55;37;18
44;Teruel;071;Castellote;676;341;335
44;Teruel;067;Castelnou;134;69;65
44;Teruel;068;Castelserás;800;423;377
44;Teruel;074;Cedrillas;639;312;327
44;Teruel;075;Celadas;367;210;157
44;Teruel;076;Cella;2571;1321;1250
44;Teruel;077;Cerollera, La;88;56;32
44;Teruel;080;Codoñera, La;319;168;151
44;Teruel;082;Corbalán;109;58;51
44;Teruel;084;Cortes de Aragón;60;28;32
44;Teruel;085;Cosa;51;32;19
44;Teruel;086;Cretas;554;281;273
44;Teruel;087;Crivillén;86;47;39
44;Teruel;088;Cuba, La;43;26;17
44;Teruel;089;Cubla;55;37;18
44;Teruel;090;Cucalón;78;49;29
44;Teruel;092;Cuervo, El;80;42;38
44;Teruel;093;Cuevas de Almudén;118;64;54
44;Teruel;094;Cuevas Labradas;137;73;64
44;Teruel;096;Ejulve;177;93;84
44;Teruel;097;Escorihuela;136;67;69
44;Teruel;099;Escucha;801;427;374
44;Teruel;100;Estercuel;205;111;94
44;Teruel;101;Ferreruela de Huerva;64;37;27
44;Teruel;102;Fonfría;26;15;11
44;Teruel;103;Formiche Alto;148;81;67
44;Teruel;105;Fórnoles;74;40;34
44;Teruel;106;Fortanete;202;118;84
44;Teruel;107;Foz-Calanda;258;131;127
44;Teruel;108;Fresneda, La;443;243;200
44;Teruel;109;Frías de Albarracín;104;64;40
44;Teruel;110;Fuenferrada;36;22;14
44;Teruel;111;Fuentes Calientes;91;52;39
44;Teruel;112;Fuentes Claras;445;242;203
44;Teruel;113;Fuentes de Rubielos;124;66;58
44;Teruel;114;Fuentespalda;282;144;138
44;Teruel;115;Galve;160;84;76
44;Teruel;116;Gargallo;97;52;45
44;Teruel;117;Gea de Albarracín;370;203;167
44;Teruel;118;Ginebrosa, La;197;111;86
44;Teruel;119;Griegos;138;84;54
44;Teruel;120;Guadalaviar;244;135;109
44;Teruel;121;Gúdar;77;47;30
44;Teruel;122;Híjar;1754;883;871
44;Teruel;123;Hinojosa de Jarque;112;63;49
44;Teruel;124;Hoz de la Vieja, La;81;44;37
44;Teruel;125;Huesa del Común;69;42;27
44;Teruel;126;Iglesuela del Cid, La;402;211;191
44;Teruel;127;Jabaloyas;59;36;23
44;Teruel;128;Jarque de la Val;62;32;30
44;Teruel;129;Jatiel;39;26;13
44;Teruel;130;Jorcas;29;17;12
44;Teruel;131;Josa;34;21;13
44;Teruel;132;Lagueruela;69;38;31
44;Teruel;133;Lanzuela;22;16;6
44;Teruel;135;Libros;100;63;37
44;Teruel;136;Lidón;54;30;24
44;Teruel;137;Linares de Mora;225;130;95
44;Teruel;141;Lledó;155;78;77
44;Teruel;138;Loscos;125;73;52
44;Teruel;142;Maicas;31;19;12
44;Teruel;143;Manzanera;516;281;235
44;Teruel;144;Martín del Río;387;186;201
44;Teruel;145;Mas de las Matas;1258;661;597
44;Teruel;146;Mata de los Olmos, La;261;132;129
44;Teruel;147;Mazaleón;511;273;238
44;Teruel;148;Mezquita de Jarque;89;51;38
44;Teruel;149;Mirambel;116;69;47
44;Teruel;150;Miravete de la Sierra;38;28;10
44;Teruel;151;Molinos;222;116;106
44;Teruel;152;Monforte de Moyuela;71;49;22
44;Teruel;153;Monreal del Campo;2487;1243;1244
44;Teruel;154;Monroyo;332;194;138
44;Teruel;155;Montalbán;1245;630;615
44;Teruel;156;Monteagudo del Castillo;49;27;22
44;Teruel;157;Monterde de Albarracín;56;34;22
44;Teruel;158;Mora de Rubielos;1512;750;762
44;Teruel;159;Moscardón;55;31;24
44;Teruel;160;Mosqueruela;532;291;241
44;Teruel;161;Muniesa;583;311;272
44;Teruel;163;Noguera de Albarracín;139;80;59
44;Teruel;164;Nogueras;21;15;6
44;Teruel;165;Nogueruelas;210;117;93
44;Teruel;167;Obón;34;16;18
44;Teruel;168;Odón;203;105;98
44;Teruel;169;Ojos Negros;341;188;153
44;Teruel;171;Olba;233;125;108
44;Teruel;172;Oliete;343;182;161
44;Teruel;173;Olmos, Los;118;62;56
44;Teruel;174;Orihuela del Tremedal;450;247;203
44;Teruel;175;Orrios;128;70;58
44;Teruel;176;Palomar de Arroyos;170;102;68
44;Teruel;177;Pancrudo;119;68;51
44;Teruel;178;Parras de Castellote, Las;55;31;24
44;Teruel;179;Peñarroya de Tastavins;446;241;205
44;Teruel;180;Peracense;77;42;35
44;Teruel;181;Peralejos;83;48;35
44;Teruel;182;Perales del Alfambra;236;128;108
44;Teruel;183;Pitarque;68;36;32
44;Teruel;184;Plou;50;31;19
44;Teruel;185;Pobo, El;108;70;38
44;Teruel;187;Portellada, La;236;120;116
44;Teruel;189;Pozondón;43;25;18
44;Teruel;190;Pozuel del Campo;63;34;29
44;Teruel;191;Puebla de Híjar, La;899;455;444
44;Teruel;192;Puebla de Valverde, La;451;250;201
44;Teruel;193;Puertomingalvo;117;58;59
44;Teruel;194;Ráfales;139;83;56
44;Teruel;195;Rillo;85;51;34
44;Teruel;196;Riodeva;134;63;71
44;Teruel;197;Ródenas;62;34;28
44;Teruel;198;Royuela;210;116;94
44;Teruel;199;Rubiales;49;28;21
44;Teruel;200;Rubielos de la Cérida;39;25;14
44;Teruel;201;Rubielos de Mora;635;328;307
44;Teruel;203;Salcedillo;11;7;4
44;Teruel;204;Saldón;24;15;9
44;Teruel;205;Samper de Calanda;721;369;352
44;Teruel;206;San Agustín;123;74;49
44;Teruel;207;San Martín del Río;132;68;64
44;Teruel;208;Santa Cruz de Nogueras;30;13;17
44;Teruel;209;Santa Eulalia;1050;540;510
44;Teruel;210;Sarrión;1148;598;550
44;Teruel;211;Segura de los Baños;41;26;15
44;Teruel;212;Seno;39;17;22
44;Teruel;213;Singra;83;48;35
44;Teruel;215;Terriente;180;97;83
44;Teruel;216;Teruel;36240;17287;18953
44;Teruel;217;Toril y Masegoso;33;26;7
44;Teruel;218;Tormón;25;15;10
44;Teruel;219;Tornos;202;104;98
44;Teruel;220;Torralba de los Sisones;157;85;72
44;Teruel;223;Torre de Arcas;94;46;48
44;Teruel;224;Torre de las Arcas;29;16;13
44;Teruel;225;Torre del Compte;117;57;60
44;Teruel;227;Torre los Negros;83;42;41
44;Teruel;221;Torrecilla de Alcañiz;439;225;214
44;Teruel;222;Torrecilla del Rebollar;123;82;41
44;Teruel;226;Torrelacárcel;143;79;64
44;Teruel;228;Torremocha de Jiloca;107;59;48
44;Teruel;229;Torres de Albarracín;185;105;80
44;Teruel;230;Torrevelilla;170;88;82
44;Teruel;231;Torrijas;43;19;24
44;Teruel;232;Torrijo del Campo;447;234;213
44;Teruel;234;Tramacastiel;67;39;28
44;Teruel;235;Tramacastilla;104;51;53
44;Teruel;236;Tronchón;68;34;34
44;Teruel;237;Urrea de Gaén;427;212;215
44;Teruel;238;Utrillas;3006;1548;1458
44;Teruel;239;Valacloche;20;11;9
44;Teruel;240;Valbona;172;98;74
44;Teruel;241;Valdealgorfa;595;294;301
44;Teruel;243;Valdecuenca;32;18;14
44;Teruel;244;Valdelinares;92;57;35
44;Teruel;245;Valdeltormo;281;134;147
44;Teruel;246;Valderrobres;2435;1242;1193
44;Teruel;247;Valjunquera;338;174;164
44;Teruel;249;Vallecillo, El;44;26;18
44;Teruel;250;Veguillas de la Sierra;21;13;8
44;Teruel;251;Villafranca del Campo;285;153;132
44;Teruel;252;Villahermosa del Campo;83;53;30
44;Teruel;256;Villanueva del Rebollar de la Sierra;42;26;16
44;Teruel;257;Villar del Cobo;160;96;64
44;Teruel;258;Villar del Salz;61;37;24
44;Teruel;260;Villarluengo;171;101;70
44;Teruel;261;Villarquemado;841;442;399
44;Teruel;262;Villarroya de los Pinares;161;85;76
44;Teruel;263;Villastar;507;251;256
44;Teruel;264;Villel;333;183;150
44;Teruel;265;Vinaceite;231;125;106
44;Teruel;266;Visiedo;131;64;67
44;Teruel;267;Vivel del Río Martín;72;37;35
44;Teruel;268;Zoma, La;32;18;14
45;Toledo;001;Ajofrín;2259;1133;1126
45;Toledo;002;Alameda de la Sagra;3734;1948;1786
45;Toledo;003;Albarreal de Tajo;679;348;331
45;Toledo;004;Alcabón;664;341;323
45;Toledo;005;Alcañizo;274;140;134
45;Toledo;006;Alcaudete de la Jara;1660;843;817
45;Toledo;007;Alcolea de Tajo;807;403;404
45;Toledo;008;Aldea en Cabo;168;85;83
45;Toledo;009;Aldeanueva de Barbarroya;501;256;245
45;Toledo;010;Aldeanueva de San Bartolomé;414;209;205
45;Toledo;011;Almendral de la Cañada;323;166;157
45;Toledo;012;Almonacid de Toledo;810;392;418
45;Toledo;013;Almorox;2170;1132;1038
45;Toledo;014;Añover de Tajo;5176;2628;2548
45;Toledo;015;Arcicóllar;908;443;465
45;Toledo;016;Argés;6563;3273;3290
45;Toledo;017;Azután;290;145;145
45;Toledo;018;Barcience;883;479;404
45;Toledo;019;Bargas;10535;5246;5289
45;Toledo;020;Belvís de la Jara;1535;768;767
45;Toledo;021;Borox;3958;2076;1882
45;Toledo;022;Buenaventura;423;211;212
45;Toledo;023;Burguillos de Toledo;3288;1699;1589
45;Toledo;024;Burujón;1307;666;641
45;Toledo;025;Cabañas de la Sagra;1857;963;894
45;Toledo;026;Cabañas de Yepes;260;136;124
45;Toledo;027;Cabezamesada;343;189;154
45;Toledo;028;Calera y Chozas;4608;2324;2284
45;Toledo;029;Caleruela;209;102;107
45;Toledo;030;Calzada de Oropesa;523;285;238
45;Toledo;031;Camarena;4082;2129;1953
45;Toledo;032;Camarenilla;577;292;285
45;Toledo;033;Campillo de la Jara, El;342;182;160
45;Toledo;034;Camuñas;1752;905;847
45;Toledo;035;Cardiel de los Montes;352;187;165
45;Toledo;036;Carmena;768;386;382
45;Toledo;037;Carpio de Tajo, El;1816;914;902
45;Toledo;038;Carranque;4953;2581;2372
45;Toledo;039;Carriches;260;135;125
45;Toledo;040;Casar de Escalona, El;1718;923;795
45;Toledo;041;Casarrubios del Monte;5995;3138;2857
45;Toledo;042;Casasbuenas;187;93;94
45;Toledo;043;Castillo de Bayuela;920;453;467
45;Toledo;045;Cazalegas;1813;936;877
45;Toledo;046;Cebolla;3209;1601;1608
45;Toledo;047;Cedillo del Condado;3826;1978;1848
45;Toledo;048;Cerralbos, Los;414;227;187
45;Toledo;049;Cervera de los Montes;499;254;245
45;Toledo;056;Chozas de Canales;4104;2145;1959
45;Toledo;057;Chueca;251;131;120
45;Toledo;050;Ciruelos;569;309;260
45;Toledo;051;Cobeja;2366;1245;1121
45;Toledo;052;Cobisa;4306;2168;2138
45;Toledo;053;Consuegra;9970;5050;4920
45;Toledo;054;Corral de Almaguer;5246;2712;2534
45;Toledo;055;Cuerva;1299;675;624
45;Toledo;058;Domingo Pérez;345;177;168
45;Toledo;059;Dosbarrios;2260;1156;1104
45;Toledo;060;Erustes;189;98;91
45;Toledo;061;Escalona;3276;1701;1575
45;Toledo;062;Escalonilla;1420;700;720
45;Toledo;063;Espinoso del Rey;425;242;183
45;Toledo;064;Esquivias;5628;2873;2755
45;Toledo;065;Estrella, La;215;115;100
45;Toledo;066;Fuensalida;11655;5901;5754
45;Toledo;067;Gálvez;3012;1502;1510
45;Toledo;068;Garciotum;202;104;98
45;Toledo;069;Gerindote;2339;1175;1164
45;Toledo;070;Guadamur;1784;891;893
45;Toledo;071;Guardia, La;2213;1118;1095
45;Toledo;072;Herencias, Las;772;415;357
45;Toledo;073;Herreruela de Oropesa;327;167;160
45;Toledo;074;Hinojosa de San Vicente;381;213;168
45;Toledo;075;Hontanar;136;79;57
45;Toledo;076;Hormigos;712;400;312
45;Toledo;077;Huecas;722;379;343
45;Toledo;078;Huerta de Valdecarábanos;1683;839;844
45;Toledo;079;Iglesuela del Tiétar, La;424;224;200
45;Toledo;080;Illán de Vacas;3;3;0
45;Toledo;081;Illescas;29558;14901;14657
45;Toledo;082;Lagartera;1354;678;676
45;Toledo;083;Layos;777;375;402
45;Toledo;084;Lillo;2561;1328;1233
45;Toledo;085;Lominchar;2475;1292;1183
45;Toledo;086;Lucillos;563;299;264
45;Toledo;087;Madridejos;10334;5147;5187
45;Toledo;088;Magán;3731;1880;1851
45;Toledo;089;Malpica de Tajo;1680;869;811
45;Toledo;090;Manzaneque;390;190;200
45;Toledo;091;Maqueda;443;217;226
45;Toledo;092;Marjaliza;243;123;120
45;Toledo;093;Marrupe;149;75;74
45;Toledo;094;Mascaraque;425;213;212
45;Toledo;095;Mata, La;817;407;410
45;Toledo;096;Mazarambroz;1244;642;602
45;Toledo;097;Mejorada;1261;646;615
45;Toledo;098;Menasalbas;2600;1372;1228
45;Toledo;099;Méntrida;5320;2729;2591
45;Toledo;100;Mesegar de Tajo;215;114;101
45;Toledo;101;Miguel Esteban;4788;2411;2377
45;Toledo;102;Mocejón;4963;2488;2475
45;Toledo;103;Mohedas de la Jara;400;222;178
45;Toledo;104;Montearagón;518;274;244
45;Toledo;105;Montesclaros;393;208;185
45;Toledo;106;Mora;9819;4918;4901
45;Toledo;107;Nambroca;4862;2498;2364
45;Toledo;108;Nava de Ricomalillo, La;519;274;245
45;Toledo;109;Navahermosa;3564;1849;1715
45;Toledo;110;Navalcán;1955;1025;930
45;Toledo;111;Navalmoralejo;58;30;28
45;Toledo;112;Navalmorales, Los;2420;1273;1147
45;Toledo;113;Navalucillos, Los;2050;1051;999
45;Toledo;114;Navamorcuende;598;299;299
45;Toledo;115;Noblejas;3652;1848;1804
45;Toledo;116;Noez;861;434;427
45;Toledo;117;Nombela;854;454;400
45;Toledo;118;Novés;3019;1550;1469
45;Toledo;119;Numancia de la Sagra;4985;2624;2361
45;Toledo;120;Nuño Gómez;125;70;55
45;Toledo;121;Ocaña;12437;6262;6175
45;Toledo;122;Olías del Rey;8120;4140;3980
45;Toledo;123;Ontígola;4540;2414;2126
45;Toledo;124;Orgaz;2605;1303;1302
45;Toledo;125;Oropesa;2626;1260;1366
45;Toledo;126;Otero;315;165;150
45;Toledo;127;Palomeque;1011;541;470
45;Toledo;128;Pantoja;3394;1705;1689
45;Toledo;129;Paredes de Escalona;112;60;52
45;Toledo;130;Parrillas;338;178;160
45;Toledo;131;Pelahustán;304;173;131
45;Toledo;132;Pepino;3128;1602;1526
45;Toledo;133;Polán;3872;1933;1939
45;Toledo;134;Portillo de Toledo;2231;1134;1097
45;Toledo;135;Puebla de Almoradiel, La;5073;2574;2499
45;Toledo;136;Puebla de Montalbán, La;7858;3969;3889
45;Toledo;137;Pueblanueva, La;2142;1079;1063
45;Toledo;138;Puente del Arzobispo, El;1225;606;619
45;Toledo;139;Puerto de San Vicente;148;80;68
45;Toledo;140;Pulgar;1491;762;729
45;Toledo;141;Quero;980;500;480
45;Toledo;142;Quintanar de la Orden;11148;5536;5612
45;Toledo;143;Quismondo;1564;791;773
45;Toledo;144;Real de San Vicente, El;919;494;425
45;Toledo;145;Recas;4504;2482;2022
45;Toledo;146;Retamoso de la Jara;103;55;48
45;Toledo;147;Rielves;749;382;367
45;Toledo;148;Robledo del Mazo;261;148;113
45;Toledo;149;Romeral, El;582;294;288
45;Toledo;150;San Bartolomé de las Abiertas;437;229;208
45;Toledo;151;San Martín de Montalbán;726;369;357
45;Toledo;152;San Martín de Pusa;629;337;292
45;Toledo;153;San Pablo de los Montes;1743;874;869
45;Toledo;154;San Román de los Montes;1921;1001;920
45;Toledo;155;Santa Ana de Pusa;350;203;147
45;Toledo;156;Santa Cruz de la Zarza;4089;2084;2005
45;Toledo;157;Santa Cruz del Retamar;3302;1736;1566
45;Toledo;158;Santa Olalla;3279;1666;1613
45;Toledo;901;Santo Domingo-Caudilla;1046;553;493
45;Toledo;159;Sartajada;94;57;37
45;Toledo;160;Segurilla;1349;684;665
45;Toledo;161;Seseña;27066;13905;13161
45;Toledo;162;Sevilleja de la Jara;668;364;304
45;Toledo;163;Sonseca;11082;5613;5469
45;Toledo;164;Sotillo de las Palomas;175;91;84
45;Toledo;165;Talavera de la Reina;83663;40156;43507
45;Toledo;166;Tembleque;1966;989;977
45;Toledo;167;Toboso, El;1741;873;868
45;Toledo;168;Toledo;85811;40941;44870
45;Toledo;169;Torralba de Oropesa;197;108;89
45;Toledo;171;Torre de Esteban Hambrán, La;1670;839;831
45;Toledo;170;Torrecilla de la Jara;207;111;96
45;Toledo;172;Torrico;698;353;345
45;Toledo;173;Torrijos;13684;6711;6973
45;Toledo;174;Totanés;355;178;177
45;Toledo;175;Turleque;736;368;368
45;Toledo;176;Ugena;5467;2830;2637
45;Toledo;177;Urda;2477;1239;1238
45;Toledo;179;Valdeverdeja;549;276;273
45;Toledo;180;Valmojado;4371;2216;2155
45;Toledo;181;Velada;2903;1493;1410
45;Toledo;182;Ventas con Peña Aguilera, Las;1062;535;527
45;Toledo;183;Ventas de Retamosa, Las;3510;1852;1658
45;Toledo;184;Ventas de San Julián, Las;233;109;124
45;Toledo;186;Villa de Don Fadrique, La;3623;1800;1823
45;Toledo;185;Villacañas;9489;4716;4773
45;Toledo;187;Villafranca de los Caballeros;4876;2426;2450
45;Toledo;188;Villaluenga de la Sagra;3887;1960;1927
45;Toledo;189;Villamiel de Toledo;926;481;445
45;Toledo;190;Villaminaya;537;271;266
45;Toledo;191;Villamuelas;606;319;287
45;Toledo;192;Villanueva de Alcardete;3172;1639;1533
45;Toledo;193;Villanueva de Bogas;699;361;338
45;Toledo;194;Villarejo de Montalbán;71;39;32
45;Toledo;195;Villarrubia de Santiago;2514;1263;1251
45;Toledo;196;Villaseca de la Sagra;1851;930;921
45;Toledo;197;Villasequilla;2522;1300;1222
45;Toledo;198;Villatobas;2482;1267;1215
45;Toledo;199;Viso de San Juan, El;4828;2574;2254
45;Toledo;200;Yébenes, Los;5882;3001;2881
45;Toledo;201;Yeles;5555;2930;2625
45;Toledo;202;Yepes;5288;2718;2570
45;Toledo;203;Yuncler;4098;2105;1993
45;Toledo;204;Yunclillos;795;411;384
45;Toledo;205;Yuncos;11646;5925;5721
46;Valencia/València;001;Ademuz;1037;558;479
46;Valencia/València;002;Ador;1730;919;811
46;Valencia/València;004;Agullent;2388;1186;1202
46;Valencia/València;042;Aielo de Malferit;4625;2326;2299
46;Valencia/València;043;Aielo de Rugat;160;88;72
46;Valencia/València;005;Alaquàs;29711;14560;15151
46;Valencia/València;006;Albaida;5914;2916;2998
46;Valencia/València;007;Albal;16577;8293;8284
46;Valencia/València;008;Albalat de la Ribera;3326;1676;1650
46;Valencia/València;009;Albalat dels Sorells;4036;1970;2066
46;Valencia/València;010;Albalat dels Tarongers;1208;640;568
46;Valencia/València;011;Alberic;10519;5209;5310
46;Valencia/València;012;Alborache;1229;639;590
46;Valencia/València;013;Alboraia/Alboraya;24741;12112;12629
46;Valencia/València;014;Albuixech;4151;2020;2131
46;Valencia/València;016;Alcàntera de Xúquer;1341;672;669
46;Valencia/València;015;Alcàsser;10196;5118;5078
46;Valencia/València;018;Alcublas;611;330;281
46;Valencia/València;020;Alcúdia de Crespins, l';5113;2534;2579
46;Valencia/València;019;Alcúdia, l';12107;5936;6171
46;Valencia/València;021;Aldaia;32204;16059;16145
46;Valencia/València;022;Alfafar;21395;10473;10922
46;Valencia/València;024;Alfara de la Baronia;569;283;286
46;Valencia/València;025;Alfara del Patriarca;3282;1577;1705
46;Valencia/València;026;Alfarp;1571;809;762
46;Valencia/València;027;Alfarrasí;1219;607;612
46;Valencia/València;023;Alfauir;449;234;215
46;Valencia/València;028;Algar de Palancia;491;260;231
46;Valencia/València;029;Algemesí;27430;13624;13806
46;Valencia/València;030;Algímia d'Alfara;1053;524;529
46;Valencia/València;031;Alginet;13827;6979;6848
46;Valencia/València;032;Almàssera;7438;3610;3828
46;Valencia/València;033;Almiserà;265;136;129
46;Valencia/València;034;Almoines;2477;1249;1228
46;Valencia/València;035;Almussafes;8979;4472;4507
46;Valencia/València;036;Alpuente;635;344;291
46;Valencia/València;037;Alqueria de la Comtessa, l';1496;721;775
46;Valencia/València;017;Alzira;44938;21946;22992
46;Valencia/València;038;Andilla;308;194;114
46;Valencia/València;039;Anna;2615;1316;1299
46;Valencia/València;040;Antella;1157;556;601
46;Valencia/València;041;Aras de los Olmos;359;205;154
46;Valencia/València;003;Atzeneta d'Albaida;1162;588;574
46;Valencia/València;044;Ayora;5283;2600;2683
46;Valencia/València;046;Barx;1303;675;628
46;Valencia/València;045;Barxeta;1586;808;778
46;Valencia/València;047;Bèlgida;679;333;346
46;Valencia/València;048;Bellreguard;4618;2300;2318
46;Valencia/València;049;Bellús;299;157;142
46;Valencia/València;050;Benagéber;180;104;76
46;Valencia/València;051;Benaguasil;11256;5780;5476
46;Valencia/València;052;Benavites;638;302;336
46;Valencia/València;053;Beneixida;627;311;316
46;Valencia/València;054;Benetússer;15000;7301;7699
46;Valencia/València;055;Beniarjó;1767;885;882
46;Valencia/València;056;Beniatjar;219;115;104
46;Valencia/València;057;Benicolet;574;280;294
46;Valencia/València;904;Benicull de Xúquer;1048;524;524
46;Valencia/València;060;Benifaió;11989;5925;6064
46;Valencia/València;059;Benifairó de la Valldigna;1558;785;773
46;Valencia/València;058;Benifairó de les Valls;2213;1109;1104
46;Valencia/València;061;Beniflá;460;232;228
46;Valencia/València;062;Benigànim;5779;2946;2833
46;Valencia/València;063;Benimodo;2272;1150;1122
46;Valencia/València;064;Benimuslem;667;355;312
46;Valencia/València;065;Beniparrell;2015;1015;1000
46;Valencia/València;066;Benirredrà;1555;752;803
46;Valencia/València;067;Benissanó;2291;1140;1151
46;Valencia/València;068;Benissoda;432;237;195
46;Valencia/València;069;Benissuera;185;89;96
46;Valencia/València;070;Bétera;24604;12244;12360
46;Valencia/València;071;Bicorp;529;256;273
46;Valencia/València;072;Bocairent;4142;2090;2052
46;Valencia/València;073;Bolbaite;1324;675;649
46;Valencia/València;074;Bonrepòs i Mirambell;3738;1841;1897
46;Valencia/València;075;Bufali;156;87;69
46;Valencia/València;076;Bugarra;739;373;366
46;Valencia/València;077;Buñol;9498;4748;4750
46;Valencia/València;078;Burjassot;38632;18641;19991
46;Valencia/València;079;Calles;355;205;150
46;Valencia/València;080;Camporrobles;1198;613;585
46;Valencia/València;081;Canals;13516;6776;6740
46;Valencia/València;082;Canet d'En Berenguer;6765;3429;3336
46;Valencia/València;083;Carcaixent;20436;10131;10305
46;Valencia/València;084;Càrcer;1827;873;954
46;Valencia/València;085;Carlet;15740;7858;7882
46;Valencia/València;086;Carrícola;99;51;48
46;Valencia/València;087;Casas Altas;131;72;59
46;Valencia/València;088;Casas Bajas;163;87;76
46;Valencia/València;089;Casinos;2780;1428;1352
46;Valencia/València;090;Castelló de Rugat;2298;1178;1120
46;Valencia/València;091;Castellonet de la Conquesta;141;78;63
46;Valencia/València;092;Castielfabib;308;161;147
46;Valencia/València;093;Catadau;2804;1399;1405
46;Valencia/València;094;Catarroja;28608;14124;14484
46;Valencia/València;095;Caudete de las Fuentes;711;376;335
46;Valencia/València;096;Cerdà;331;179;152
46;Valencia/València;107;Chella;2472;1231;1241
46;Valencia/València;106;Chelva;1531;786;745
46;Valencia/València;108;Chera;469;250;219
46;Valencia/València;109;Cheste;8735;4461;4274
46;Valencia/València;111;Chiva;15414;7874;7540
46;Valencia/València;112;Chulilla;662;358;304
46;Valencia/València;097;Cofrentes;1123;572;551
46;Valencia/València;098;Corbera;3088;1547;1541
46;Valencia/València;099;Cortes de Pallás;771;427;344
46;Valencia/València;100;Cotes;333;172;161
46;Valencia/València;105;Cullera;22521;11269;11252
46;Valencia/València;113;Daimús;3196;1584;1612
46;Valencia/València;114;Domeño;673;332;341
46;Valencia/València;115;Dos Aguas;327;184;143
46;Valencia/València;116;Eliana, l';18362;8963;9399
46;Valencia/València;117;Emperador;688;350;338
46;Valencia/València;118;Enguera;4777;2392;2385
46;Valencia/València;119;Ènova, l';902;464;438
46;Valencia/València;120;Estivella;1441;698;743
46;Valencia/València;121;Estubeny;125;63;62
46;Valencia/València;122;Faura;3553;1788;1765
46;Valencia/València;123;Favara;2504;1280;1224
46;Valencia/València;126;Foios;7452;3677;3775
46;Valencia/València;128;Font de la Figuera, la;2027;1020;1007
46;Valencia/València;127;Font d'En Carròs, la;3778;1880;1898
46;Valencia/València;124;Fontanars dels Alforins;959;500;459
46;Valencia/València;125;Fortaleny;1020;503;517
46;Valencia/València;129;Fuenterrobles;694;382;312
46;Valencia/València;131;Gandia;75798;37242;38556
46;Valencia/València;902;Gátova;405;194;211
46;Valencia/València;130;Gavarda;1042;502;540
46;Valencia/València;132;Genovés, el;2778;1397;1381
46;Valencia/València;133;Gestalgar;548;293;255
46;Valencia/València;134;Gilet;3404;1755;1649
46;Valencia/València;135;Godella;13131;6299;6832
46;Valencia/València;136;Godelleta;3584;1847;1737
46;Valencia/València;137;Granja de la Costera, la;295;149;146
46;Valencia/València;138;Guadasséquies;456;233;223
46;Valencia/València;139;Guadassuar;5902;2866;3036
46;Valencia/València;140;Guardamar de la Safor;531;281;250
46;Valencia/València;141;Higueruelas;501;265;236
46;Valencia/València;142;Jalance;834;433;401
46;Valencia/València;144;Jarafuel;769;397;372
46;Valencia/València;154;Llanera de Ranes;1047;533;514
46;Valencia/València;155;Llaurí;1130;583;547
46;Valencia/València;147;Llíria;23482;11841;11641
46;Valencia/València;152;Llocnou de la Corona;124;66;58
46;Valencia/València;153;Llocnou de Sant Jeroni;554;276;278
46;Valencia/València;151;Llocnou d'En Fenollet;916;474;442
46;Valencia/València;156;Llombai;2653;1322;1331
46;Valencia/València;157;Llosa de Ranes, la;3642;1871;1771
46;Valencia/València;150;Llutxent;2326;1188;1138
46;Valencia/València;148;Loriguilla;2035;1050;985
46;Valencia/València;149;Losa del Obispo;505;257;248
46;Valencia/València;158;Macastre;1300;687;613
46;Valencia/València;159;Manises;31240;15422;15818
46;Valencia/València;160;Manuel;2436;1202;1234
46;Valencia/València;161;Marines;1848;972;876
46;Valencia/València;162;Massalavés;1610;844;766
46;Valencia/València;163;Massalfassar;2555;1271;1284
46;Valencia/València;164;Massamagrell;16163;8013;8150
46;Valencia/València;165;Massanassa;9782;4840;4942
46;Valencia/València;166;Meliana;10970;5376;5594
46;Valencia/València;167;Millares;331;169;162
46;Valencia/València;168;Miramar;2685;1371;1314
46;Valencia/València;169;Mislata;44320;21499;22821
46;Valencia/València;170;Mogente/Moixent;4307;2159;2148
46;Valencia/València;171;Moncada;22021;10771;11250
46;Valencia/València;173;Montaverner;1635;812;823
46;Valencia/València;174;Montesa;1155;585;570
46;Valencia/València;175;Montitxelvo/Montichelvo;585;293;292
46;Valencia/València;176;Montroi/Montroy;2956;1568;1388
46;Valencia/València;172;Montserrat;8188;4226;3962
46;Valencia/València;177;Museros;6596;3362;3234
46;Valencia/València;178;Nàquera/Náquera;6897;3561;3336
46;Valencia/València;179;Navarrés;3004;1498;1506
46;Valencia/València;180;Novelé/Novetlè;857;414;443
46;Valencia/València;181;Oliva;25224;12390;12834
46;Valencia/València;183;Olleria, l';8320;4174;4146
46;Valencia/València;182;Olocau;1828;973;855
46;Valencia/València;184;Ontinyent;35761;17658;18103
46;Valencia/València;185;Otos;422;213;209
46;Valencia/València;186;Paiporta;26514;13065;13449
46;Valencia/València;187;Palma de Gandía;1709;886;823
46;Valencia/València;188;Palmera;1018;515;503
46;Valencia/València;189;Palomar, el;567;287;280
46;Valencia/València;190;Paterna;71035;35129;35906
46;Valencia/València;191;Pedralba;2814;1485;1329
46;Valencia/València;192;Petrés;999;505;494
46;Valencia/València;193;Picanya;11606;5733;5873
46;Valencia/València;194;Picassent;21263;10697;10566
46;Valencia/València;195;Piles;2740;1377;1363
46;Valencia/València;196;Pinet;157;77;80
46;Valencia/València;199;Pobla de Farnals, la;8128;4117;4011
46;Valencia/València;202;Pobla de Vallbona, la;24858;12547;12311
46;Valencia/València;200;Pobla del Duc, la;2515;1214;1301
46;Valencia/València;203;Pobla Llarga, la;4452;2234;2218
46;Valencia/València;197;Polinyà de Xúquer;2503;1268;1235
46;Valencia/València;198;Potries;1060;544;516
46;Valencia/València;205;Puçol;19737;9754;9983
46;Valencia/València;201;Puebla de San Miguel;61;38;23
46;Valencia/València;204;Puig de Santa Maria, el;8718;4248;4470
46;Valencia/València;101;Quart de les Valls;1024;486;538
46;Valencia/València;102;Quart de Poblet;25062;12219;12843
46;Valencia/València;103;Quartell;1655;792;863
46;Valencia/València;104;Quatretonda;2202;1094;1108
46;Valencia/València;206;Quesa;663;344;319
46;Valencia/València;207;Rafelbunyol;9149;4497;4652
46;Valencia/València;208;Rafelcofer;1355;651;704
46;Valencia/València;209;Rafelguaraf;2355;1163;1192
46;Valencia/València;210;Ráfol de Salem;442;213;229
46;Valencia/València;212;Real;2207;1150;1057
46;Valencia/València;211;Real de Gandia, el;2531;1274;1257
46;Valencia/València;213;Requena;20405;10184;10221
46;Valencia/València;214;Riba-roja de Túria;22761;11541;11220
46;Valencia/València;215;Riola;1790;900;890
46;Valencia/València;216;Rocafort;7314;3566;3748
46;Valencia/València;217;Rotglà i Corberà;1117;555;562
46;Valencia/València;218;Rótova;1293;669;624
46;Valencia/València;219;Rugat;174;93;81
46;Valencia/València;220;Sagunto/Sagunt;67173;32919;34254
46;Valencia/València;221;Salem;418;213;205
46;Valencia/València;903;San Antonio de Benagéber;9286;4563;4723
46;Valencia/València;222;Sant Joanet;507;255;252
46;Valencia/València;223;Sedaví;10391;5065;5326
46;Valencia/València;224;Segart;164;88;76
46;Valencia/València;225;Sellent;384;195;189
46;Valencia/València;226;Sempere;30;16;14
46;Valencia/València;227;Senyera;1134;555;579
46;Valencia/València;228;Serra;3187;1631;1556
46;Valencia/València;229;Siete Aguas;1159;606;553
46;Valencia/València;230;Silla;19078;9491;9587
46;Valencia/València;231;Simat de la Valldigna;3297;1652;1645
46;Valencia/València;232;Sinarcas;1105;579;526
46;Valencia/València;233;Sollana;4881;2383;2498
46;Valencia/València;234;Sot de Chera;362;203;159
46;Valencia/València;235;Sueca;27566;13580;13986
46;Valencia/València;236;Sumacàrcer;1097;542;555
46;Valencia/València;237;Tavernes Blanques;9224;4483;4741
46;Valencia/València;238;Tavernes de la Valldigna;17254;8591;8663
46;Valencia/València;239;Teresa de Cofrentes;619;328;291
46;Valencia/València;240;Terrateig;256;136;120
46;Valencia/València;241;Titaguas;454;237;217
46;Valencia/València;242;Torrebaja;402;225;177
46;Valencia/València;243;Torrella;145;81;64
46;Valencia/València;244;Torrent;83962;41367;42595
46;Valencia/València;245;Torres Torres;669;360;309
46;Valencia/València;246;Tous;1287;647;640
46;Valencia/València;247;Tuéjar;1137;600;537
46;Valencia/València;248;Turís;6722;3515;3207
46;Valencia/València;249;Utiel;11458;5724;5734
46;Valencia/València;250;València;800215;380293;419922
46;Valencia/València;251;Vallada;3096;1561;1535
46;Valencia/València;252;Vallanca;133;71;62
46;Valencia/València;253;Vallés;154;82;72
46;Valencia/València;254;Venta del Moro;1198;636;562
46;Valencia/València;255;Vilallonga/Villalonga;4370;2138;2232
46;Valencia/València;256;Vilamarxant;9891;5103;4788
46;Valencia/València;257;Villanueva de Castellón;7054;3470;3584
46;Valencia/València;258;Villar del Arzobispo;3536;1793;1743
46;Valencia/València;259;Villargordo del Cabriel;582;296;286
46;Valencia/València;260;Vinalesa;3412;1655;1757
46;Valencia/València;145;Xàtiva;29623;14496;15127
46;Valencia/València;143;Xeraco;5720;2871;2849
46;Valencia/València;146;Xeresa;2197;1119;1078
46;Valencia/València;110;Xirivella;30197;14963;15234
46;Valencia/València;261;Yátova;2079;1072;1007
46;Valencia/València;262;Yesa, La;221;118;103
46;Valencia/València;263;Zarra;346;193;153
47;Valladolid;001;Adalia;53;31;22
47;Valladolid;002;Aguasal;18;12;6
47;Valladolid;003;Aguilar de Campos;254;146;108
47;Valladolid;004;Alaejos;1379;738;641
47;Valladolid;005;Alcazarén;630;344;286
47;Valladolid;006;Aldea de San Miguel;213;118;95
47;Valladolid;007;Aldeamayor de San Martín;5634;2917;2717
47;Valladolid;008;Almenara de Adaja;22;11;11
47;Valladolid;009;Amusquillo;102;63;39
47;Valladolid;010;Arroyo de la Encomienda;20537;10317;10220
47;Valladolid;011;Ataquines;569;312;257
47;Valladolid;012;Bahabón;103;49;54
47;Valladolid;013;Barcial de la Loma;91;51;40
47;Valladolid;014;Barruelo del Valle;48;30;18
47;Valladolid;015;Becilla de Valderaduey;234;133;101
47;Valladolid;016;Benafarces;69;36;33
47;Valladolid;017;Bercero;196;108;88
47;Valladolid;018;Berceruelo;35;22;13
47;Valladolid;019;Berrueces;108;61;47
47;Valladolid;020;Bobadilla del Campo;292;163;129
47;Valladolid;021;Bocigas;90;48;42
47;Valladolid;022;Bocos de Duero;72;36;36
47;Valladolid;023;Boecillo;4148;2118;2030
47;Valladolid;024;Bolaños de Campos;289;162;127
47;Valladolid;025;Brahojos de Medina;116;60;56
47;Valladolid;026;Bustillo de Chaves;65;36;29
47;Valladolid;027;Cabezón de Pisuerga;3763;1915;1848
47;Valladolid;028;Cabezón de Valderaduey;41;24;17
47;Valladolid;029;Cabreros del Monte;66;36;30
47;Valladolid;030;Campaspero;1060;595;465
47;Valladolid;031;Campillo, El;213;124;89
47;Valladolid;032;Camporredondo;149;86;63
47;Valladolid;033;Canalejas de Peñafiel;238;132;106
47;Valladolid;034;Canillas de Esgueva;75;43;32
47;Valladolid;035;Carpio;994;535;459
47;Valladolid;036;Casasola de Arión;250;141;109
47;Valladolid;037;Castrejón de Trabancos;177;87;90
47;Valladolid;038;Castrillo de Duero;109;63;46
47;Valladolid;039;Castrillo-Tejeriego;163;89;74
47;Valladolid;040;Castrobol;56;29;27
47;Valladolid;041;Castrodeza;154;93;61
47;Valladolid;042;Castromembibre;54;39;15
47;Valladolid;043;Castromonte;318;171;147
47;Valladolid;044;Castronuevo de Esgueva;370;199;171
47;Valladolid;045;Castronuño;833;417;416
47;Valladolid;046;Castroponce;138;76;62
47;Valladolid;047;Castroverde de Cerrato;215;133;82
47;Valladolid;048;Ceinos de Campos;210;112;98
47;Valladolid;049;Cervillego de la Cruz;87;51;36
47;Valladolid;050;Cigales;5328;2714;2614
47;Valladolid;051;Ciguñuela;371;194;177
47;Valladolid;052;Cistérniga;9016;4561;4455
47;Valladolid;053;Cogeces de Íscar;136;66;70
47;Valladolid;054;Cogeces del Monte;659;354;305
47;Valladolid;055;Corcos;203;110;93
47;Valladolid;056;Corrales de Duero;113;65;48
47;Valladolid;057;Cubillas de Santa Marta;329;191;138
47;Valladolid;058;Cuenca de Campos;215;112;103
47;Valladolid;059;Curiel de Duero;118;76;42
47;Valladolid;060;Encinas de Esgueva;231;136;95
47;Valladolid;061;Esguevillas de Esgueva;265;147;118
47;Valladolid;062;Fombellida;176;102;74
47;Valladolid;063;Fompedraza;100;52;48
47;Valladolid;064;Fontihoyuelo;39;23;16
47;Valladolid;065;Fresno el Viejo;878;473;405
47;Valladolid;066;Fuensaldaña;1954;1008;946
47;Valladolid;067;Fuente el Sol;150;79;71
47;Valladolid;068;Fuente-Olmedo;34;18;16
47;Valladolid;069;Gallegos de Hornija;115;58;57
47;Valladolid;070;Gatón de Campos;32;18;14
47;Valladolid;071;Geria;506;240;266
47;Valladolid;073;Herrín de Campos;122;64;58
47;Valladolid;074;Hornillos de Eresma;166;96;70
47;Valladolid;075;Íscar;6341;3191;3150
47;Valladolid;076;Laguna de Duero;22765;11351;11414
47;Valladolid;077;Langayo;250;157;93
47;Valladolid;079;Llano de Olmedo;60;31;29
47;Valladolid;078;Lomoviejo;178;96;82
47;Valladolid;080;Manzanillo;54;26;28
47;Valladolid;081;Marzales;43;21;22
47;Valladolid;082;Matapozuelos;1033;523;510
47;Valladolid;083;Matilla de los Caños;100;54;46
47;Valladolid;084;Mayorga;1478;730;748
47;Valladolid;086;Medina de Rioseco;4606;2272;2334
47;Valladolid;085;Medina del Campo;20416;9947;10469
47;Valladolid;087;Megeces;427;232;195
47;Valladolid;088;Melgar de Abajo;114;63;51
47;Valladolid;089;Melgar de Arriba;153;87;66
47;Valladolid;090;Mojados;3258;1701;1557
47;Valladolid;091;Monasterio de Vega;82;45;37
47;Valladolid;092;Montealegre de Campos;110;65;45
47;Valladolid;093;Montemayor de Pililla;857;465;392
47;Valladolid;094;Moral de la Reina;148;83;65
47;Valladolid;095;Moraleja de las Panaderas;43;23;20
47;Valladolid;096;Morales de Campos;141;73;68
47;Valladolid;097;Mota del Marqués;349;188;161
47;Valladolid;098;Mucientes;653;328;325
47;Valladolid;099;Mudarra, La;157;80;77
47;Valladolid;100;Muriel;122;65;57
47;Valladolid;101;Nava del Rey;1975;1014;961
47;Valladolid;102;Nueva Villa de las Torres;272;157;115
47;Valladolid;103;Olivares de Duero;296;165;131
47;Valladolid;104;Olmedo;3646;1813;1833
47;Valladolid;105;Olmos de Esgueva;185;102;83
47;Valladolid;106;Olmos de Peñafiel;53;30;23
47;Valladolid;109;Palazuelo de Vedija;179;93;86
47;Valladolid;110;Parrilla, La;479;242;237
47;Valladolid;111;Pedraja de Portillo, La;1126;576;550
47;Valladolid;112;Pedrajas de San Esteban;3314;1690;1624
47;Valladolid;113;Pedrosa del Rey;158;91;67
47;Valladolid;114;Peñafiel;5054;2546;2508
47;Valladolid;115;Peñaflor de Hornija;302;169;133
47;Valladolid;116;Pesquera de Duero;442;241;201
47;Valladolid;117;Piña de Esgueva;318;168;150
47;Valladolid;118;Piñel de Abajo;159;88;71
47;Valladolid;119;Piñel de Arriba;91;50;41
47;Valladolid;121;Pollos;601;327;274
47;Valladolid;122;Portillo;2373;1235;1138
47;Valladolid;123;Pozal de Gallinas;547;299;248
47;Valladolid;124;Pozaldez;478;256;222
47;Valladolid;125;Pozuelo de la Orden;46;28;18
47;Valladolid;126;Puras;43;24;19
47;Valladolid;127;Quintanilla de Arriba;162;92;70
47;Valladolid;129;Quintanilla de Onésimo;1026;544;482
47;Valladolid;130;Quintanilla de Trigueros;101;50;51
47;Valladolid;128;Quintanilla del Molar;61;30;31
47;Valladolid;131;Rábano;174;90;84
47;Valladolid;132;Ramiro;43;24;19
47;Valladolid;133;Renedo de Esgueva;3814;1949;1865
47;Valladolid;134;Roales de Campos;161;89;72
47;Valladolid;135;Robladillo;91;54;37
47;Valladolid;137;Roturas;28;17;11
47;Valladolid;138;Rubí de Bracamonte;228;129;99
47;Valladolid;139;Rueda;1237;645;592
47;Valladolid;140;Saelices de Mayorga;108;66;42
47;Valladolid;141;Salvador de Zapardiel;116;67;49
47;Valladolid;142;San Cebrián de Mazote;129;77;52
47;Valladolid;143;San Llorente;105;62;43
47;Valladolid;144;San Martín de Valvení;81;45;36
47;Valladolid;145;San Miguel del Arroyo;659;349;310
47;Valladolid;146;San Miguel del Pino;344;175;169
47;Valladolid;147;San Pablo de la Moraleja;112;63;49
47;Valladolid;148;San Pedro de Latarce;476;257;219
47;Valladolid;149;San Pelayo;50;26;24
47;Valladolid;150;San Román de Hornija;307;145;162
47;Valladolid;151;San Salvador;25;15;10
47;Valladolid;156;San Vicente del Palacio;162;86;76
47;Valladolid;152;Santa Eufemia del Arroyo;72;40;32
47;Valladolid;153;Santervás de Campos;113;61;52
47;Valladolid;154;Santibáñez de Valcorba;168;97;71
47;Valladolid;155;Santovenia de Pisuerga;4604;2360;2244
47;Valladolid;157;Sardón de Duero;579;309;270
47;Valladolid;158;Seca, La;1059;546;513
47;Valladolid;159;Serrada;1103;574;529
47;Valladolid;160;Siete Iglesias de Trabancos;431;234;197
47;Valladolid;161;Simancas;5267;2672;2595
47;Valladolid;162;Tamariz de Campos;73;43;30
47;Valladolid;163;Tiedra;287;139;148
47;Valladolid;164;Tordehumos;411;218;193
47;Valladolid;165;Tordesillas;8745;4412;4333
47;Valladolid;169;Torre de Esgueva;65;34;31
47;Valladolid;170;Torre de Peñafiel;48;29;19
47;Valladolid;166;Torrecilla de la Abadesa;276;133;143
47;Valladolid;167;Torrecilla de la Orden;248;123;125
47;Valladolid;168;Torrecilla de la Torre;36;23;13
47;Valladolid;171;Torrelobatón;400;211;189
47;Valladolid;172;Torrescárcela;159;83;76
47;Valladolid;173;Traspinedo;1111;589;522
47;Valladolid;174;Trigueros del Valle;304;167;137
47;Valladolid;175;Tudela de Duero;8620;4381;4239
47;Valladolid;176;Unión de Campos, La;230;119;111
47;Valladolid;177;Urones de Castroponce;110;66;44
47;Valladolid;178;Urueña;189;106;83
47;Valladolid;179;Valbuena de Duero;462;254;208
47;Valladolid;180;Valdearcos de la Vega;55;30;25
47;Valladolid;181;Valdenebro de los Valles;199;105;94
47;Valladolid;182;Valdestillas;1632;845;787
47;Valladolid;183;Valdunquillo;144;69;75
47;Valladolid;186;Valladolid;299265;140247;159018
47;Valladolid;184;Valoria la Buena;630;342;288
47;Valladolid;185;Valverde de Campos;91;55;36
47;Valladolid;187;Vega de Ruiponce;89;55;34
47;Valladolid;188;Vega de Valdetronco;118;64;54
47;Valladolid;189;Velascálvaro;165;92;73
47;Valladolid;190;Velilla;114;57;57
47;Valladolid;191;Velliza;112;74;38
47;Valladolid;192;Ventosa de la Cuesta;96;57;39
47;Valladolid;193;Viana de Cega;2062;1071;991
47;Valladolid;195;Villabáñez;489;272;217
47;Valladolid;196;Villabaruz de Campos;30;14;16
47;Valladolid;197;Villabrágima;1053;553;500
47;Valladolid;198;Villacarralón;74;45;29
47;Valladolid;199;Villacid de Campos;72;45;27
47;Valladolid;200;Villaco;74;49;25
47;Valladolid;203;Villafrades de Campos;62;33;29
47;Valladolid;204;Villafranca de Duero;267;137;130
47;Valladolid;205;Villafrechós;480;263;217
47;Valladolid;206;Villafuerte;85;47;38
47;Valladolid;207;Villagarcía de Campos;300;179;121
47;Valladolid;208;Villagómez la Nueva;64;34;30
47;Valladolid;209;Villalán de Campos;32;20;12
47;Valladolid;210;Villalar de los Comuneros;468;225;243
47;Valladolid;211;Villalba de la Loma;50;26;24
47;Valladolid;212;Villalba de los Alcores;368;200;168
47;Valladolid;213;Villalbarba;115;55;60
47;Valladolid;214;Villalón de Campos;1561;776;785
47;Valladolid;215;Villamuriel de Campos;49;25;24
47;Valladolid;216;Villán de Tordesillas;117;67;50
47;Valladolid;217;Villanubla;2769;1420;1349
47;Valladolid;218;Villanueva de Duero;1189;623;566
47;Valladolid;219;Villanueva de la Condesa;56;29;27
47;Valladolid;220;Villanueva de los Caballeros;180;94;86
47;Valladolid;221;Villanueva de los Infantes;99;59;40
47;Valladolid;222;Villanueva de San Mancio;82;45;37
47;Valladolid;223;Villardefrades;162;90;72
47;Valladolid;224;Villarmentero de Esgueva;106;58;48
47;Valladolid;225;Villasexmir;72;42;30
47;Valladolid;226;Villavaquerín;161;89;72
47;Valladolid;227;Villavellid;50;32;18
47;Valladolid;228;Villaverde de Medina;513;278;235
47;Valladolid;229;Villavicencio de los Caballeros;233;116;117
47;Valladolid;194;Viloria;339;178;161
47;Valladolid;230;Wamba;310;167;143
47;Valladolid;231;Zaratán;6235;3193;3042
47;Valladolid;232;Zarza, La;110;60;50
49;Zamora;002;Abezames;59;30;29
49;Zamora;003;Alcañices;1065;560;505
49;Zamora;004;Alcubilla de Nogales;115;63;52
49;Zamora;005;Alfaraz de Sayago;125;74;51
49;Zamora;006;Algodre;141;77;64
49;Zamora;007;Almaraz de Duero;401;208;193
49;Zamora;008;Almeida de Sayago;437;237;200
49;Zamora;009;Andavías;452;227;225
49;Zamora;010;Arcenillas;428;220;208
49;Zamora;011;Arcos de la Polvorosa;217;119;98
49;Zamora;012;Argañín;73;38;35
49;Zamora;013;Argujillo;230;117;113
49;Zamora;014;Arquillinos;119;62;57
49;Zamora;015;Arrabalde;212;106;106
49;Zamora;016;Aspariegos;245;110;135
49;Zamora;017;Asturianos;260;132;128
49;Zamora;018;Ayoó de Vidriales;289;144;145
49;Zamora;019;Barcial del Barco;247;128;119
49;Zamora;020;Belver de los Montes;265;144;121
49;Zamora;021;Benavente;17787;8579;9208
49;Zamora;022;Benegiles;304;161;143
49;Zamora;023;Bermillo de Sayago;1007;535;472
49;Zamora;024;Bóveda de Toro, La;699;349;350
49;Zamora;025;Bretó;160;92;68
49;Zamora;026;Bretocino;208;113;95
49;Zamora;027;Brime de Sog;130;62;68
49;Zamora;028;Brime de Urz;106;61;45
49;Zamora;029;Burganes de Valverde;654;345;309
49;Zamora;030;Bustillo del Oro;80;43;37
49;Zamora;031;Cabañas de Sayago;151;84;67
49;Zamora;032;Calzadilla de Tera;299;148;151
49;Zamora;033;Camarzana de Tera;755;373;382
49;Zamora;034;Cañizal;445;232;213
49;Zamora;035;Cañizo;228;125;103
49;Zamora;036;Carbajales de Alba;506;255;251
49;Zamora;037;Carbellino;179;95;84
49;Zamora;038;Casaseca de Campeán;95;54;41
49;Zamora;039;Casaseca de las Chanas;381;198;183
49;Zamora;040;Castrillo de la Guareña;117;62;55
49;Zamora;041;Castrogonzalo;465;255;210
49;Zamora;042;Castronuevo;225;108;117
49;Zamora;043;Castroverde de Campos;272;143;129
49;Zamora;044;Cazurra;76;40;36
49;Zamora;046;Cerecinos de Campos;257;143;114
49;Zamora;047;Cerecinos del Carrizal;111;64;47
49;Zamora;048;Cernadilla;119;63;56
49;Zamora;050;Cobreros;568;310;258
49;Zamora;052;Coomonte;198;111;87
49;Zamora;053;Coreses;1044;538;506
49;Zamora;054;Corrales del Vino;959;470;489
49;Zamora;055;Cotanes del Monte;98;55;43
49;Zamora;056;Cubillos;300;145;155
49;Zamora;057;Cubo de Benavente;116;62;54
49;Zamora;058;Cubo de Tierra del Vino, El;322;172;150
49;Zamora;059;Cuelgamures;81;52;29
49;Zamora;061;Entrala;154;83;71
49;Zamora;062;Espadañedo;111;58;53
49;Zamora;063;Faramontanos de Tábara;319;164;155
49;Zamora;064;Fariza;495;259;236
49;Zamora;065;Fermoselle;1164;591;573
49;Zamora;066;Ferreras de Abajo;479;241;238
49;Zamora;067;Ferreras de Arriba;348;193;155
49;Zamora;068;Ferreruela;446;247;199
49;Zamora;069;Figueruela de Arriba;336;161;175
49;Zamora;071;Fonfría;750;394;356
49;Zamora;075;Fresno de la Polvorosa;132;72;60
49;Zamora;076;Fresno de la Ribera;375;193;182
49;Zamora;077;Fresno de Sayago;161;84;77
49;Zamora;078;Friera de Valverde;144;76;68
49;Zamora;079;Fuente Encalada;102;57;45
49;Zamora;080;Fuentelapeña;669;354;315
49;Zamora;082;Fuentes de Ropel;376;196;180
49;Zamora;081;Fuentesaúco;1587;799;788
49;Zamora;083;Fuentesecas;45;24;21
49;Zamora;084;Fuentespreadas;280;151;129
49;Zamora;085;Galende;982;493;489
49;Zamora;086;Gallegos del Pan;111;65;46
49;Zamora;087;Gallegos del Río;466;258;208
49;Zamora;088;Gamones;89;53;36
49;Zamora;090;Gema;215;106;109
49;Zamora;091;Granja de Moreruela;271;140;131
49;Zamora;092;Granucillo;119;59;60
49;Zamora;093;Guarrate;331;171;160
49;Zamora;094;Hermisende;221;113;108
49;Zamora;095;Hiniesta, La;313;166;147
49;Zamora;096;Jambrina;150;81;69
49;Zamora;097;Justel;64;42;22
49;Zamora;098;Losacino;210;118;92
49;Zamora;099;Losacio;95;55;40
49;Zamora;100;Lubián;304;160;144
49;Zamora;101;Luelmo;147;80;67
49;Zamora;102;Maderal, El;177;97;80
49;Zamora;103;Madridanos;452;238;214
49;Zamora;104;Mahide;316;178;138
49;Zamora;105;Maire de Castroponce;141;75;66
49;Zamora;107;Malva;122;51;71
49;Zamora;108;Manganeses de la Lampreana;465;231;234
49;Zamora;109;Manganeses de la Polvorosa;624;305;319
49;Zamora;110;Manzanal de Arriba;358;185;173
49;Zamora;112;Manzanal de los Infantes;120;69;51
49;Zamora;111;Manzanal del Barco;121;63;58
49;Zamora;113;Matilla de Arzón;164;99;65
49;Zamora;114;Matilla la Seca;42;24;18
49;Zamora;115;Mayalde;177;97;80
49;Zamora;116;Melgar de Tera;366;195;171
49;Zamora;117;Micereces de Tera;435;222;213
49;Zamora;118;Milles de la Polvorosa;213;115;98
49;Zamora;119;Molacillos;242;130;112
49;Zamora;120;Molezuelas de la Carballeda;50;27;23
49;Zamora;121;Mombuey;401;211;190
49;Zamora;122;Monfarracinos;951;497;454
49;Zamora;123;Montamarta;569;303;266
49;Zamora;124;Moral de Sayago;257;147;110
49;Zamora;126;Moraleja de Sayago;291;146;145
49;Zamora;125;Moraleja del Vino;1732;871;861
49;Zamora;128;Morales de Rey;569;289;280
49;Zamora;129;Morales de Toro;954;494;460
49;Zamora;130;Morales de Valverde;163;81;82
49;Zamora;127;Morales del Vino;2971;1554;1417
49;Zamora;131;Moralina;241;124;117
49;Zamora;132;Moreruela de los Infanzones;334;175;159
49;Zamora;133;Moreruela de Tábara;305;166;139
49;Zamora;134;Muelas de los Caballeros;176;102;74
49;Zamora;135;Muelas del Pan;615;317;298
49;Zamora;136;Muga de Sayago;353;173;180
49;Zamora;137;Navianos de Valverde;174;99;75
49;Zamora;138;Olmillos de Castro;213;115;98
49;Zamora;139;Otero de Bodas;150;82;68
49;Zamora;141;Pajares de la Lampreana;306;156;150
49;Zamora;143;Palacios de Sanabria;230;118;112
49;Zamora;142;Palacios del Pan;259;133;126
49;Zamora;145;Pedralba de la Pradería;222;123;99
49;Zamora;146;Pego, El;284;144;140
49;Zamora;147;Peleagonzalo;276;134;142
49;Zamora;148;Peleas de Abajo;288;130;158
49;Zamora;149;Peñausende;384;201;183
49;Zamora;150;Peque;127;55;72
49;Zamora;151;Perdigón, El;673;357;316
49;Zamora;152;Pereruela;515;280;235
49;Zamora;153;Perilla de Castro;161;87;74
49;Zamora;154;Pías;111;63;48
49;Zamora;155;Piedrahita de Castro;92;52;40
49;Zamora;156;Pinilla de Toro;217;113;104
49;Zamora;157;Pino del Oro;183;99;84
49;Zamora;158;Piñero, El;232;121;111
49;Zamora;160;Pobladura de Valderaduey;40;22;18
49;Zamora;159;Pobladura del Valle;289;154;135
49;Zamora;162;Porto;156;87;69
49;Zamora;163;Pozoantiguo;204;103;101
49;Zamora;164;Pozuelo de Tábara;154;79;75
49;Zamora;165;Prado;53;31;22
49;Zamora;166;Puebla de Sanabria;1356;656;700
49;Zamora;167;Pueblica de Valverde;189;103;86
49;Zamora;170;Quintanilla de Urz;106;52;54
49;Zamora;168;Quintanilla del Monte;97;57;40
49;Zamora;169;Quintanilla del Olmo;39;20;19
49;Zamora;171;Quiruelas de Vidriales;652;345;307
49;Zamora;172;Rabanales;501;264;237
49;Zamora;173;Rábano de Aliste;353;175;178
49;Zamora;174;Requejo;149;74;75
49;Zamora;175;Revellinos;249;131;118
49;Zamora;176;Riofrío de Aliste;635;348;287
49;Zamora;177;Rionegro del Puente;260;133;127
49;Zamora;178;Roales;942;495;447
49;Zamora;179;Robleda-Cervantes;395;210;185
49;Zamora;180;Roelos de Sayago;145;72;73
49;Zamora;181;Rosinos de la Requejada;348;188;160
49;Zamora;183;Salce;93;41;52
49;Zamora;184;Samir de los Caños;172;98;74
49;Zamora;185;San Agustín del Pozo;175;92;83
49;Zamora;186;San Cebrián de Castro;237;118;119
49;Zamora;187;San Cristóbal de Entreviñas;1369;717;652
49;Zamora;188;San Esteban del Molar;122;72;50
49;Zamora;189;San Justo;208;108;100
49;Zamora;190;San Martín de Valderaduey;52;27;25
49;Zamora;191;San Miguel de la Ribera;290;143;147
49;Zamora;192;San Miguel del Valle;135;67;68
49;Zamora;193;San Pedro de Ceque;438;232;206
49;Zamora;194;San Pedro de la Nave-Almendra;337;172;165
49;Zamora;208;San Vicente de la Cabeza;357;191;166
49;Zamora;209;San Vitero;492;276;216
49;Zamora;197;Santa Clara de Avedillo;158;79;79
49;Zamora;199;Santa Colomba de las Monjas;255;124;131
49;Zamora;200;Santa Cristina de la Polvorosa;1073;551;522
49;Zamora;201;Santa Croya de Tera;297;151;146
49;Zamora;202;Santa Eufemia del Barco;175;101;74
49;Zamora;203;Santa María de la Vega;293;152;141
49;Zamora;204;Santa María de Valverde;59;29;30
49;Zamora;205;Santibáñez de Tera;368;186;182
49;Zamora;206;Santibáñez de Vidriales;922;467;455
49;Zamora;207;Santovenia;235;119;116
49;Zamora;210;Sanzoles;486;248;238
49;Zamora;214;Tábara;740;372;368
49;Zamora;216;Tapioles;151;88;63
49;Zamora;219;Toro;8665;4260;4405
49;Zamora;220;Torre del Valle, La;148;82;66
49;Zamora;221;Torregamones;253;132;121
49;Zamora;222;Torres del Carrizal;400;203;197
49;Zamora;223;Trabazos;835;448;387
49;Zamora;224;Trefacio;185;99;86
49;Zamora;225;Uña de Quintana;131;70;61
49;Zamora;226;Vadillo de la Guareña;250;133;117
49;Zamora;227;Valcabado;404;208;196
49;Zamora;228;Valdefinjas;54;30;24
49;Zamora;229;Valdescorriel;125;63;62
49;Zamora;230;Vallesa de la Guareña;81;44;37
49;Zamora;231;Vega de Tera;321;160;161
49;Zamora;232;Vega de Villalobos;92;38;54
49;Zamora;233;Vegalatrave;84;44;40
49;Zamora;234;Venialbo;420;224;196
49;Zamora;235;Vezdemarbán;448;235;213
49;Zamora;236;Vidayanes;85;46;39
49;Zamora;237;Videmala;144;73;71
49;Zamora;238;Villabrázaro;248;134;114
49;Zamora;239;Villabuena del Puente;649;333;316
49;Zamora;240;Villadepera;197;109;88
49;Zamora;241;Villaescusa;246;135;111
49;Zamora;242;Villafáfila;469;247;222
49;Zamora;243;Villaferrueña;109;53;56
49;Zamora;244;Villageriz;48;29;19
49;Zamora;245;Villalazán;260;130;130
49;Zamora;246;Villalba de la Lampreana;218;122;96
49;Zamora;247;Villalcampo;419;210;209
49;Zamora;248;Villalobos;235;122;113
49;Zamora;249;Villalonso;73;39;34
49;Zamora;250;Villalpando;1457;716;741
49;Zamora;251;Villalube;170;89;81
49;Zamora;252;Villamayor de Campos;338;173;165
49;Zamora;255;Villamor de los Escuderos;371;193;178
49;Zamora;256;Villanázar;270;140;130
49;Zamora;257;Villanueva de Azoague;358;183;175
49;Zamora;258;Villanueva de Campeán;119;63;56
49;Zamora;259;Villanueva de las Peras;79;36;43
49;Zamora;260;Villanueva del Campo;823;398;425
49;Zamora;263;Villar de Fallaves;44;25;19
49;Zamora;264;Villar del Buey;556;286;270
49;Zamora;261;Villaralbo;1810;915;895
49;Zamora;262;Villardeciervos;399;202;197
49;Zamora;265;Villardiegua de la Ribera;114;64;50
49;Zamora;266;Villárdiga;73;42;31
49;Zamora;267;Villardondiego;106;61;45
49;Zamora;268;Villarrín de Campos;390;212;178
49;Zamora;269;Villaseco del Pan;228;105;123
49;Zamora;270;Villavendimio;177;106;71
49;Zamora;272;Villaveza de Valverde;71;37;34
49;Zamora;271;Villaveza del Agua;176;96;80
49;Zamora;273;Viñas;167;90;77
49;Zamora;275;Zamora;60988;28299;32689
50;Zaragoza;001;Abanto;92;56;36
50;Zaragoza;002;Acered;158;91;67
50;Zaragoza;003;Agón;138;80;58
50;Zaragoza;004;Aguarón;624;332;292
50;Zaragoza;005;Aguilón;233;127;106
50;Zaragoza;006;Ainzón;1064;544;520
50;Zaragoza;007;Aladrén;52;33;19
50;Zaragoza;008;Alagón;7154;3562;3592
50;Zaragoza;009;Alarba;116;66;50
50;Zaragoza;010;Alberite de San Juan;74;44;30
50;Zaragoza;011;Albeta;134;68;66
50;Zaragoza;012;Alborge;107;56;51
50;Zaragoza;013;Alcalá de Ebro;245;119;126
50;Zaragoza;014;Alcalá de Moncayo;143;83;60
50;Zaragoza;015;Alconchel de Ariza;76;43;33
50;Zaragoza;016;Aldehuela de Liestos;51;34;17
50;Zaragoza;017;Alfajarín;2339;1186;1153
50;Zaragoza;018;Alfamén;1443;757;686
50;Zaragoza;019;Alforque;65;37;28
50;Zaragoza;020;Alhama de Aragón;1011;526;485
50;Zaragoza;021;Almochuel;24;12;12
50;Zaragoza;022;Almolda, La;554;278;276
50;Zaragoza;023;Almonacid de la Cuba;230;113;117
50;Zaragoza;024;Almonacid de la Sierra;753;423;330
50;Zaragoza;025;Almunia de Doña Godina, La;8091;4176;3915
50;Zaragoza;026;Alpartir;568;289;279
50;Zaragoza;027;Ambel;253;125;128
50;Zaragoza;028;Anento;95;62;33
50;Zaragoza;029;Aniñón;684;366;318
50;Zaragoza;030;Añón de Moncayo;222;133;89
50;Zaragoza;031;Aranda de Moncayo;145;92;53
50;Zaragoza;032;Arándiga;278;145;133
50;Zaragoza;033;Ardisa;74;47;27
50;Zaragoza;034;Ariza;1100;574;526
50;Zaragoza;035;Artieda;80;48;32
50;Zaragoza;036;Asín;98;52;46
50;Zaragoza;037;Atea;147;91;56
50;Zaragoza;038;Ateca;1762;924;838
50;Zaragoza;039;Azuara;529;297;232
50;Zaragoza;040;Badules;78;42;36
50;Zaragoza;041;Bagüés;16;9;7
50;Zaragoza;042;Balconchán;20;7;13
50;Zaragoza;043;Bárboles;282;152;130
50;Zaragoza;044;Bardallur;254;126;128
50;Zaragoza;045;Belchite;1526;770;756
50;Zaragoza;046;Belmonte de Gracián;194;108;86
50;Zaragoza;047;Berdejo;40;28;12
50;Zaragoza;048;Berrueco;32;20;12
50;Zaragoza;901;Biel;155;97;58
50;Zaragoza;050;Bijuesca;94;65;29
50;Zaragoza;051;Biota;930;474;456
50;Zaragoza;052;Bisimbre;81;46;35
50;Zaragoza;053;Boquiñeni;776;389;387
50;Zaragoza;054;Bordalba;52;33;19
50;Zaragoza;055;Borja;4978;2538;2440
50;Zaragoza;056;Botorrita;490;271;219
50;Zaragoza;057;Brea de Aragón;1589;808;781
50;Zaragoza;058;Bubierca;65;34;31
50;Zaragoza;059;Bujaraloz;980;500;480
50;Zaragoza;060;Bulbuente;220;119;101
50;Zaragoza;061;Bureta;206;106;100
50;Zaragoza;062;Burgo de Ebro, El;2486;1254;1232
50;Zaragoza;063;Buste, El;71;40;31
50;Zaragoza;064;Cabañas de Ebro;496;264;232
50;Zaragoza;065;Cabolafuente;53;32;21
50;Zaragoza;066;Cadrete;4235;2257;1978
50;Zaragoza;067;Calatayud;20092;9930;10162
50;Zaragoza;068;Calatorao;2860;1488;1372
50;Zaragoza;069;Calcena;73;43;30
50;Zaragoza;070;Calmarza;61;35;26
50;Zaragoza;071;Campillo de Aragón;146;80;66
50;Zaragoza;072;Carenas;189;109;80
50;Zaragoza;073;Cariñena;3355;1695;1660
50;Zaragoza;074;Caspe;10026;5295;4731
50;Zaragoza;075;Castejón de Alarba;88;55;33
50;Zaragoza;076;Castejón de las Armas;78;43;35
50;Zaragoza;077;Castejón de Valdejasa;209;104;105
50;Zaragoza;078;Castiliscar;254;133;121
50;Zaragoza;079;Cervera de la Cañada;260;147;113
50;Zaragoza;080;Cerveruela;34;22;12
50;Zaragoza;081;Cetina;583;303;280
50;Zaragoza;092;Chiprana;497;261;236
50;Zaragoza;093;Chodes;104;57;47
50;Zaragoza;082;Cimballa;94;45;49
50;Zaragoza;083;Cinco Olivas;102;52;50
50;Zaragoza;084;Clarés de Ribota;67;38;29
50;Zaragoza;085;Codo;199;106;93
50;Zaragoza;086;Codos;248;160;88
50;Zaragoza;087;Contamina;32;18;14
50;Zaragoza;088;Cosuenda;337;171;166
50;Zaragoza;089;Cuarte de Huerva;13450;6853;6597
50;Zaragoza;090;Cubel;155;75;80
50;Zaragoza;091;Cuerlas, Las;41;22;19
50;Zaragoza;094;Daroca;1965;958;1007
50;Zaragoza;095;Ejea de los Caballeros;16984;8694;8290
50;Zaragoza;096;Embid de Ariza;35;19;16
50;Zaragoza;098;Encinacorba;178;92;86
50;Zaragoza;099;Épila;4372;2277;2095
50;Zaragoza;100;Erla;341;176;165
50;Zaragoza;101;Escatrón;1067;531;536
50;Zaragoza;102;Fabara;1109;599;510
50;Zaragoza;104;Farlete;366;180;186
50;Zaragoza;105;Fayón;380;200;180
50;Zaragoza;106;Fayos, Los;131;69;62
50;Zaragoza;107;Figueruelas;1262;631;631
50;Zaragoza;108;Fombuena;60;39;21
50;Zaragoza;109;Frago, El;97;62;35
50;Zaragoza;110;Frasno, El;379;215;164
50;Zaragoza;111;Fréscano;199;112;87
50;Zaragoza;113;Fuendejalón;784;421;363
50;Zaragoza;114;Fuendetodos;145;85;60
50;Zaragoza;115;Fuentes de Ebro;4549;2345;2204
50;Zaragoza;116;Fuentes de Jiloca;229;125;104
50;Zaragoza;117;Gallocanta;136;75;61
50;Zaragoza;118;Gallur;2566;1298;1268
50;Zaragoza;119;Gelsa;996;525;471
50;Zaragoza;120;Godojos;53;28;25
50;Zaragoza;121;Gotor;302;157;145
50;Zaragoza;122;Grisel;74;43;31
50;Zaragoza;123;Grisén;590;306;284
50;Zaragoza;124;Herrera de los Navarros;489;268;221
50;Zaragoza;125;Ibdes;395;202;193
50;Zaragoza;126;Illueca;2809;1403;1406
50;Zaragoza;128;Isuerre;31;16;15
50;Zaragoza;129;Jaraba;282;155;127
50;Zaragoza;130;Jarque de Moncayo;417;221;196
50;Zaragoza;131;Jaulín;251;129;122
50;Zaragoza;132;Joyosa, La;1101;566;535
50;Zaragoza;133;Lagata;109;57;52
50;Zaragoza;134;Langa del Castillo;122;63;59
50;Zaragoza;135;Layana;94;52;42
50;Zaragoza;136;Lécera;631;339;292
50;Zaragoza;138;Lechón;46;26;20
50;Zaragoza;137;Leciñena;1146;582;564
50;Zaragoza;139;Letux;342;185;157
50;Zaragoza;140;Litago;164;93;71
50;Zaragoza;141;Lituénigo;123;66;57
50;Zaragoza;142;Lobera de Onsella;26;14;12
50;Zaragoza;143;Longares;883;534;349
50;Zaragoza;144;Longás;32;22;10
50;Zaragoza;146;Lucena de Jalón;232;127;105
50;Zaragoza;147;Luceni;955;485;470
50;Zaragoza;148;Luesia;297;165;132
50;Zaragoza;149;Luesma;37;22;15
50;Zaragoza;150;Lumpiaque;806;420;386
50;Zaragoza;151;Luna;684;357;327
50;Zaragoza;152;Maella;2008;1088;920
50;Zaragoza;153;Magallón;1112;565;547
50;Zaragoza;154;Mainar;160;86;74
50;Zaragoza;155;Malanquilla;89;59;30
50;Zaragoza;156;Maleján;276;143;133
50;Zaragoza;160;Mallén;3004;1550;1454
50;Zaragoza;157;Malón;369;182;187
50;Zaragoza;159;Maluenda;937;456;481
50;Zaragoza;161;Manchones;106;57;49
50;Zaragoza;162;Mara;168;84;84
50;Zaragoza;163;María de Huerva;5970;3032;2938
50;Zaragoza;902;Marracos;84;46;38
50;Zaragoza;164;Mediana de Aragón;447;219;228
50;Zaragoza;165;Mequinenza;2279;1155;1124
50;Zaragoza;166;Mesones de Isuela;257;130;127
50;Zaragoza;167;Mezalocha;233;134;99
50;Zaragoza;168;Mianos;27;15;12
50;Zaragoza;169;Miedes de Aragón;415;219;196
50;Zaragoza;170;Monegrillo;394;217;177
50;Zaragoza;171;Moneva;114;69;45
50;Zaragoza;172;Monreal de Ariza;189;110;79
50;Zaragoza;173;Monterde;143;93;50
50;Zaragoza;174;Montón;90;54;36
50;Zaragoza;175;Morata de Jalón;1066;533;533
50;Zaragoza;176;Morata de Jiloca;276;161;115
50;Zaragoza;177;Morés;321;167;154
50;Zaragoza;178;Moros;319;164;155
50;Zaragoza;179;Moyuela;265;146;119
50;Zaragoza;180;Mozota;120;60;60
50;Zaragoza;181;Muel;1401;710;691
50;Zaragoza;182;Muela, La;5894;3061;2833
50;Zaragoza;183;Munébrega;363;198;165
50;Zaragoza;184;Murero;96;56;40
50;Zaragoza;185;Murillo de Gállego;191;113;78
50;Zaragoza;186;Navardún;36;22;14
50;Zaragoza;187;Nigüella;61;38;23
50;Zaragoza;188;Nombrevilla;31;19;12
50;Zaragoza;189;Nonaspe;978;534;444
50;Zaragoza;190;Novallas;825;438;387
50;Zaragoza;191;Novillas;517;256;261
50;Zaragoza;192;Nuévalos;285;159;126
50;Zaragoza;193;Nuez de Ebro;838;419;419
50;Zaragoza;194;Olvés;110;64;46
50;Zaragoza;195;Orcajo;55;34;21
50;Zaragoza;196;Orera;111;60;51
50;Zaragoza;197;Orés;109;69;40
50;Zaragoza;198;Oseja;47;29;18
50;Zaragoza;199;Osera de Ebro;383;191;192
50;Zaragoza;200;Paniza;619;330;289
50;Zaragoza;201;Paracuellos de Jiloca;573;302;271
50;Zaragoza;202;Paracuellos de la Ribera;136;71;65
50;Zaragoza;203;Pastriz;1300;632;668
50;Zaragoza;204;Pedrola;3587;1880;1707
50;Zaragoza;205;Pedrosas, Las;86;40;46
50;Zaragoza;206;Perdiguera;572;306;266
50;Zaragoza;207;Piedratajada;87;48;39
50;Zaragoza;208;Pina de Ebro;2391;1221;1170
50;Zaragoza;209;Pinseque;4070;2087;1983
50;Zaragoza;210;Pintanos, Los;39;25;14
50;Zaragoza;211;Plasencia de Jalón;308;175;133
50;Zaragoza;212;Pleitas;33;13;20
50;Zaragoza;213;Plenas;98;53;45
50;Zaragoza;214;Pomer;21;14;7
50;Zaragoza;215;Pozuel de Ariza;21;12;9
50;Zaragoza;216;Pozuelo de Aragón;282;146;136
50;Zaragoza;217;Pradilla de Ebro;540;292;248
50;Zaragoza;218;Puebla de Albortón;120;73;47
50;Zaragoza;219;Puebla de Alfindén, La;6358;3254;3104
50;Zaragoza;220;Puendeluna;48;28;20
50;Zaragoza;221;Purujosa;32;21;11
50;Zaragoza;222;Quinto;1949;983;966
50;Zaragoza;223;Remolinos;1074;548;526
50;Zaragoza;224;Retascón;62;36;26
50;Zaragoza;225;Ricla;2869;1534;1335
50;Zaragoza;227;Romanos;125;66;59
50;Zaragoza;228;Rueda de Jalón;312;170;142
50;Zaragoza;229;Ruesca;76;35;41
50;Zaragoza;241;Sabiñán;722;392;330
50;Zaragoza;230;Sádaba;1311;667;644
50;Zaragoza;231;Salillas de Jalón;321;157;164
50;Zaragoza;232;Salvatierra de Esca;207;96;111
50;Zaragoza;233;Samper del Salz;100;58;42
50;Zaragoza;234;San Martín de la Virgen de Moncayo;270;152;118
50;Zaragoza;235;San Mateo de Gállego;3269;1671;1598
50;Zaragoza;236;Santa Cruz de Grío;105;66;39
50;Zaragoza;237;Santa Cruz de Moncayo;123;67;56
50;Zaragoza;238;Santa Eulalia de Gállego;97;55;42
50;Zaragoza;239;Santed;64;42;22
50;Zaragoza;240;Sástago;1119;554;565
50;Zaragoza;242;Sediles;108;63;45
50;Zaragoza;243;Sestrica;344;196;148
50;Zaragoza;244;Sierra de Luna;270;138;132
50;Zaragoza;245;Sigüés;79;42;37
50;Zaragoza;246;Sisamón;35;23;12
50;Zaragoza;247;Sobradiel;1136;545;591
50;Zaragoza;248;Sos del Rey Católico;567;297;270
50;Zaragoza;249;Tabuenca;321;187;134
50;Zaragoza;250;Talamantes;61;28;33
50;Zaragoza;251;Tarazona;10558;5259;5299
50;Zaragoza;252;Tauste;6847;3422;3425
50;Zaragoza;253;Terrer;464;250;214
50;Zaragoza;254;Tierga;190;104;86
50;Zaragoza;255;Tobed;230;122;108
50;Zaragoza;256;Torralba de los Frailes;76;42;34
50;Zaragoza;257;Torralba de Ribota;169;94;75
50;Zaragoza;258;Torralbilla;59;34;25
50;Zaragoza;259;Torrehermosa;69;37;32
50;Zaragoza;260;Torrelapaja;35;23;12
50;Zaragoza;261;Torrellas;246;126;120
50;Zaragoza;262;Torres de Berrellén;1443;744;699
50;Zaragoza;263;Torrijo de la Cañada;197;116;81
50;Zaragoza;264;Tosos;183;104;79
50;Zaragoza;265;Trasmoz;88;50;38
50;Zaragoza;266;Trasobares;115;72;43
50;Zaragoza;267;Uncastillo;621;295;326
50;Zaragoza;268;Undués de Lerda;57;32;25
50;Zaragoza;269;Urrea de Jalón;435;252;183
50;Zaragoza;270;Urriés;43;22;21
50;Zaragoza;271;Used;256;141;115
50;Zaragoza;272;Utebo;18822;9365;9457
50;Zaragoza;274;Val de San Martín;61;36;25
50;Zaragoza;273;Valdehorna;33;19;14
50;Zaragoza;275;Valmadrid;112;69;43
50;Zaragoza;276;Valpalmas;137;65;72
50;Zaragoza;277;Valtorres;61;27;34
50;Zaragoza;278;Velilla de Ebro;203;110;93
50;Zaragoza;279;Velilla de Jiloca;81;39;42
50;Zaragoza;280;Vera de Moncayo;322;168;154
50;Zaragoza;281;Vierlas;82;43;39
50;Zaragoza;283;Villadoz;95;55;40
50;Zaragoza;284;Villafeliche;154;85;69
50;Zaragoza;285;Villafranca de Ebro;838;418;420
50;Zaragoza;286;Villalba de Perejil;96;49;47
50;Zaragoza;287;Villalengua;293;161;132
50;Zaragoza;903;Villamayor de Gállego;2745;1375;1370
50;Zaragoza;288;Villanueva de Gállego;4728;2377;2351
50;Zaragoza;290;Villanueva de Huerva;434;226;208
50;Zaragoza;289;Villanueva de Jiloca;52;27;25
50;Zaragoza;291;Villar de los Navarros;113;64;49
50;Zaragoza;292;Villarreal de Huerva;273;156;117
50;Zaragoza;293;Villarroya de la Sierra;435;233;202
50;Zaragoza;294;Villarroya del Campo;89;48;41
50;Zaragoza;282;Vilueña, La;62;31;31
50;Zaragoza;295;Vistabella;48;27;21
50;Zaragoza;296;Zaida, La;447;229;218
50;Zaragoza;297;Zaragoza;681877;326103;355774
50;Zaragoza;298;Zuera;8576;4450;4126
